Data	Data aligned
LPLPAPHAQY	LPLPPHAQY
FPRSMLSIF	FPRSMLSIF
HPYFYAPEL	HPYFYAPEL
APVGGHILSY	APVGHILSY
FPGPSKPF	FPG-PSKPF
HHTFYNELR	HHTFYNELR
SPWADNTAL	SPWADNTAL
FPAKVTAHW	FPAKVTAHW
MPSPVSPKL	MPSPVSPKL
FPHPVNQVTF	FPHPNQVTF
TPTGIKVVM	TPTGIKVVM
LPFFPIATY	LPFFPIATY
EQISDIDDAVR	ISDIDDAVR
HAMVILLTL	HAMVILLTL
YPSNIFISF	YPSNIFISF
HPLSVLGINY	HPLSLGINY
TPFVDPRVY	TPFVDPRVY
SAASEQHVF	SAASEQHVF
YPNSHTHYF	YPNSHTHYF
NPKVVKMKI	NPKVVKMKI
VPTELALLY	VPTELALLY
NIITILESY	NIITILESY
YPVEHPDKF	YPVEHPDKF
YTSQFVSL	YTS-QFVSL
LPTELDGGDQE	LPTEGGDQE
LPSEHQTIL	LPSEHQTIL
FPWGDGNHTLF	FPWGGNHTL
APATSILEY	APATSILEY
MPIREGDTVTL	MPIRDTVTL
HAVVNLINY	HAVVNLINY
HAVEWPVVM	HAVEWPVVM
HPIEGSTTVF	HPIESTTVF
YGFQEKEAF	YGFQEKEAF
YPVEIHEYL	YPVEIHEYL
TPLEEAIKF	TPLEEAIKF
VPVTLIGEAVF	VPVTGEAVF
LPVLERLIY	LPVLERLIY
LPSKLDYFTY	LPSKDYFTY
FPSEDILLV	FPSEDILLV
MPNQIVQIL	MPNQIVQIL
QPMSFVLEF	QPMSFVLEF
FPLAPLLAL	FPLAPLLAL
HPIPDLTGY	HPIPDLTGY
HPTIISESF	HPTIISESF
LPIDPNEPTY	LPIDNEPTY
NAFASVILF	NAFASVILF
FPNVSSFEW	FPNVSSFEW
NVADVVIKF	NVADVVIKF
APFTEGISF	APFTEGISF
KPLFNMEDKI	KPLFNMEDK
EAFLNNQEY	EAFLNNQEY
FPGSEDVKL	FPGSEDVKL
IDTIEIITDR	DTIEIITDR
QEVAVKEQLT	QEVAVKEQL
MPAVKAIIY	MPAVKAIIY
MAAMPQTVY	MAAMPQTVY
TAVPTLLKY	TAVPTLLKY
MAWLVDHVY	MAWLVDHVY
QPAQDIFSVY	QPAQIFSVY
HPIIPEQSTF	HPIIEQSTF
MAVIDGNVM	MAVIDGNVM
VPVSVVECF	VPVSVVECF
LPVEQGFTF	LPVEQGFTF
FPWGDGNHTL	FPWGGNHTL
FANPEDCVAF	FANPDCVAF
NAAKVFNLY	NAAKVFNLY
SPMDIFDMF	SPMDIFDMF
LLEELEEGQK	LLEEEEGQK
APEEHPVLL	APEEHPVLL
NVIRDAVTY	NVIRDAVTY
SPYADTQNSY	SPYATQNSY
SPGLRDVAL	SPGLRDVAL
QALEILFTY	QALEILFTY
QAAMPQVSY	QAAMPQVSY
RPFADLLGTAF	FADLLGTAF
VPYPDDLVGF	VPYPDLVGF
SVSEVIEGY	SVSEVIEGY
LPDMVVSHLF	LPDMVSHLF
VPNPVINPY	VPNPVINPY
IPVTIITGY	IPVTIITGY
IPHMDIEAL	IPHMDIEAL
KPVEGYDISF	KPVEYDISF
LPHPYAIAVF	LPHPAIAVF
LPQEDLEAL	LPQEDLEAL
SPRVPLSAY	SPRVPLSAY
TANGYILFF	TANGYILFF
FPMEIRQY	FPM-EIRQY
RPVPKGATY	RPVPKGATY
LPFSAGSLLVY	LPFSSLLVY
MPEPDAQRFF	MPEPDAQRF
HPQPGAVEL	HPQPGAVEL
IPIWGTLIQY	IPIWTLIQY
EPIYPEVVHMF	EPIYVVHMF
EAFDELLASKY	EAFDLLASK
DVIRLIMQY	DVIRLIMQY
LAWLDEHTL	LAWLDEHTL
DITSDTSGDFR	ITSDTSGDF
TANPFPVPSL	TANPPVPSL
HPTDPLTSF	HPTDPLTSF
VPVPPLPEY	VPVPPLPEY
LPEDIKRVY	LPEDIKRVY
LPPPVHVDY	LPPPVHVDY
MPFEIRLPEF	MPFERLPEF
NAISVTTSY	NAISVTTSY
FPEHIFPAL	FPEHIFPAL
DPNLEFVAM	DPNLEFVAM
FPSLQRLVY	FPSLQRLVY
NAFPEENMNY	NAFPENMNY
LPLLPNVSY	LPLLPNVSY
FPVGDVNNF	FPVGDVNNF
LALEPGVAY	LALEPGVAY
LAQQYYLVY	LAQQYYLVY
LPAKILVEF	LPAKILVEF
LPSGVGPEY	LPSGVGPEY
IPWDDLIAL	IPWDDLIAL
TPIQDNVDQTY	TPIQVDQTY
IPYEGFASL	IPYEGFASL
IPNEIIHAL	IPNEIIHAL
HPLGDIVAF	HPLGDIVAF
FPALAPLTY	FPALAPLTY
IALKAVTNF	IALKAVTNF
YPFPTFQPAF	YPFPFQPAF
LLTDIIAAY	LLTDIIAAY
FPEAYKPTVY	FPEAKPTVY
EPNPDDPLM	EPNPDDPLM
FPVFATVIL	FPVFATVIL
EAIGAVIHY	EAIGAVIHY
RPPGFSPFR	RPPGFSPFR
NPFHWGEVEY	NPFHGEVEY
LPIVTPAL	LPI-VTPAL
FEELNADLFR	FEELNADLF
YPAEITLTW	YPAEITLTW
FPNIPGKSL	FPNIPGKSL
DPSAQQFCQY	DPSAQFCQY
NAMDVVVQF	NAMDVVVQF
MPQGLVISF	MPQGLVISF
MPLHTIIPLL	MPLHIIPLL
HPVWALIYY	HPVWALIYY
FPSIIYSMSI	FPS-IIYSM
FPYDYSASEY	FPYDSASEY
ELSDIAHR	ELS-DIAHR
EVIPYTPAM	EVIPYTPAM
VALNFIISY	VALNFIISY
NPFEYYIFF	NPFEYYIFF
SAMEVVPAL	SAMEVVPAL
DPVLMFLLF	DPVLMFLLF
FPAGIYDTKY	FPAGYDTKY
ALELEQER	ALE-LEQER
SPYWEERIFY	SPYWERIFY
FPEHMANVEL	FPEHANVEL
FPEPNPRVIEL	EPNPRVIEL
HAVSPIAKY	HAVSPIAKY
RPDGTLNSF	RPDGTLNSF
HPTSVISGY	HPTSVISGY
LPSLEYGANY	LPSLYGANY
HPNIVSLQDVL	HPNILQDVL
FPVTPVSTL	FPVTPVSTL
FPYEESKEKF	FPYESKEKF
YPNVNIHNF	YPNVNIHNF
LPAEFFEVL	LPAEFFEVL
YIDQEELNK	YIDQEELNK
IAFFDVRTF	IAFFDVRTF
FPETTSPHEY	FPETSPHEY
LPFLPSTEDVY	LPFLTEDVY
FPPDAILFY	FPPDAILFY
FAANVYEAF	FAANVYEAF
SPLPAQLVY	SPLPAQLVY
FPELDSPQL	FPELDSPQL
FPIEYHDIW	FPIEYHDIW
SPTCLTLIY	SPTCLTLIY
IPNGVQIFF	IPNGVQIFF
EPFHLIVSY	EPFHLIVSY
TAMDVVYAL	TAMDVVYAL
YPLWGGIMY	YPLWGGIMY
ELTDEEAER	ELTDEEAER
LPSDVSILY	LPSDVSILY
VPVPPNVAF	VPVPPNVAF
LPAGIVAVL	LPAGIVAVL
FPAELGIVF	FPAELGIVF
MPEDVKNFY	MPEDVKNFY
IPFDPKFITY	IPFDKFITY
VSTEVDAR	VST-EVDAR
DPRLKECMDM	DPR-LKECM
TALAAFLSY	TALAAFLSY
IPWVIEPVY	IPWVIEPVY
VPVDVVVNM	VPVDVVVNM
IAIDVIDAY	IAIDVIDAY
FPMELRQFL	FPMELRQFL
FPTQALNFAF	FPTQLNFAF
NAFEELVAF	NAFEELVAF
IPITDSLSF	IPITDSLSF
NPVNYGRPY	NPVNYGRPY
LPAEHQFSF	LPAEHQFSF
EAIKILKGEY	EAIKLKGEY
LPAPPTQNM	LPAPPTQNM
FPDKPITQY	FPDKPITQY
DVNFEFPEFQL	DVNFEFPEF
LPFPDETHERY	LPFPETHER
DPIGGHIHSY	DPIGHIHSY
LPLPLPMAL	LPLPLPMAL
EDTEEHHLR	EDTEEHHLR
YPFKPPKVAF	YPFKPKVAF
PDPAKSAPAPK	DPAKAPAPK
LVYNGVYQY	LVYNGVYQY
DPYYGYEDF	DPYYGYEDF
FAFDPSVNY	FAFDPSVNY
LPADWAPLF	LPADWAPLF
LKDDEVAQL	LKDDEVAQL
LPNWLINSY	LPNWLINSY
MPLQLLLLL	MPLQLLLLL
LPYNDYFEYF	LPYNDYFEY
FPMTHGNTGF	FPMTGNTGF
DLTDYLMK	DLT-DYLMK
LPDGSRVEL	LPDGSRVEL
MPADIATLL	MPADIATLL
SPIQFESAW	SPIQFESAW
IPVPINAEL	IPVPINAEL
LPYPDLETY	LPYPDLETY
VPLEIMIKF	VPLEIMIKF
MPETTETVL	MPETTETVL
YEWDVAEAR	YEWDVAEAR
YPIDPVTQEF	YPIDVTQEF
DAWLEMNPGY	DAWLMNPGY
VPHSIINGY	VPHSIINGY
LVIEDDVR	LVI-EDDVR
YPSEFSTYL	YPSEFSTYL
SPIDVVEKY	SPIDVVEKY
YPETLGRLLIL	YPETLGRLL
KEVVEEAENGR	EVVEAENGR
TPTEISLVL	TPTEISLVL
DAIRSLASVSY	DAIRASVSY
FPFFDIAHY	FPFFDIAHY
YAWESSAGGSF	YAWEAGGSF
VPVEEPIAF	VPVEEPIAF
TLEEDEEELFK	LEEDEEELF
PDPSKSAPAPK	DPSKAPAPK
HPTLGPKITY	HPTLPKITY
TPVPGGVGPM	TPVPGVGPM
FPFEKGSVQY	FPFEGSVQY
SPVYIAIFY	SPVYIAIFY
LPMVPIVAL	LPMVPIVAL
DASPVQAVF	DASPVQAVF
LPIPSKLLEF	LPIPKLLEF
TVFGSLIIGY	TVFGLIIGY
VPRIQLEEY	VPRIQLEEY
HACGVIATI	HACGVIATI
FPFNPLDFESF	FPFNDFESF
LPPKIVIGY	LPPKIVIGY
LPDVSLQEF	LPDVSLQEF
LPFPIIQQY	LPFPIIQQY
LPELNTRAF	LPELNTRAF
NPLDEQHIF	NPLDEQHIF
YPLSPTKISQY	YPLSKISQY
LPLDLEDIF	LPLDLEDIF
EMEAELEDERK	MEAELEDER
FAFFDPVMY	FAFFDPVMY
LPVIFLPIF	LPVIFLPIF
FPVYVLPKVEY	FPVYPKVEY
DPFPAAIIL	DPFPAAIIL
LPLHVLPLY	LPLHVLPLY
IPMSIISFF	IPMSIISFF
LAIPITNTY	LAIPITNTY
DAFLEQAVSY	DAFLQAVSY
LPTGVYLNF	LPTGVYLNF
PPTVTLTEY	PPTVTLTEY
VLPGVDALSNI	LPGVDALSN
TPAPVEKSPA	TPAPVEKSP
HAVIDINAF	HAVIDINAF
YPDPVSIIQKY	DPVSIIQKY
TAIRALETY	TAIRALETY
YAFQDDRYLY	YAFQDRYLY
QVHPDTGISSK	HPDTGISSK
MPDSAAALL	MPDSAAALL
TPFAFVIDL	TPFAFVIDL
MPAPEIVSY	MPAPEIVSY
FPASPPKGY	FPASPPKGY
TAAVAAFVLY	AAVAAFVLY
VPWLSSVRY	VPWLSSVRY
FPEGSVELY	FPEGSVELY
LPGGPTLTF	LPGGPTLTF
NAFSANLNF	NAFSANLNF
LPREELWIY	LPREELWIY
SPDLRLTWL	SPDLRLTWL
TAAAVGAVF	TAAAVGAVF
YPENIVPSF	YPENIVPSF
IPEEDAGKLY	IPEEAGKLY
TIPYLTALL	TIPYLTALL
NPVFIEPTF	NPVFIEPTF
LPFPKIDPY	LPFPKIDPY
QAITLVTQY	QAITLVTQY
FPEVYVPTVF	FPEVVPTVF
LPADVQNYY	LPADVQNYY
LPSSEVVKF	LPSSEVVKF
HPTVVISAY	HPTVVISAY
TAFTLAHIHY	TAFTAHIHY
DAFPLAFDY	DAFPLAFDY
LPPEELVPY	LPPEELVPY
IGPLGLSPK	IGPLGLSPK
MPSVVGVLVF	MPSVGVLVF
VPASLPVEF	VPASLPVEF
RVEIMEEESEQ	EIMEEESEQ
IAIPVTVAF	IAIPVTVAF
HPILNDPIY	HPILNDPIY
FPLIEVNKVYY	FPLIVNKVY
FPDQVAIQL	FPDQVAIQL
NPVSWVQTF	NPVSWVQTF
VPFDQFIQL	VPFDQFIQL
KPAPDETSF	KPAPDETSF
QAFQERLNSY	QAFQRLNSY
DPFKDIILY	DPFKDIILY
TPIKDGILY	TPIKDGILY
APDELHYTY	APDELHYTY
LPTEPPYTAY	LPTEPYTAY
FPNAIEHTL	FPNAIEHTL
LPWVGKELY	LPWVGKELY
DPIYKENIM	DPIYKENIM
MVNHFIAEF	MVNHFIAEF
NADTLALVF	NADTLALVF
FPFESGKPF	FPFESGKPF
MVHSLIEAY	MVHSLIEAY
VPHSLETLY	VPHSLETLY
TASELKILY	TASELKILY
IEEELGSK	IEE-ELGSK
TPLDFLHIF	TPLDFLHIF
TGEGFYKY	TGE-GFYKY
YATFIVTNY	YATFIVTNY
MPQFSTIEY	MPQFSTIEY
IPQLCEDLF	IPQLCEDLF
MPDDLLTTL	MPDDLLTTL
KLEDGPKFLK	LEDGPKFLK
FIIPNVVK	FII-PNVVK
VPTATPAPI	VPTATPAPI
SPVDSVLFY	SPVDSVLFY
RPIFIITEY	RPIFIITEY
EAIVTVIM	EAI-VTVIM
YPLDVQKEF	YPLDVQKEF
CPPSEGDDY	CPPSEGDDY
VEVTEFEDIK	EVTEFEDIK
LPALPTQAL	LPALPTQAL
APALPGPQF	APALPGPQF
LPLNSVYVY	LPLNSVYVY
LPYRATENDIY	LPYRENDIY
DYFEQYGK	DYF-EQYGK
VGVNGFGR	VGV-NGFGR
VPDSSGPERIL	VPDSSGPER
NPFNMPNLY	NPFNMPNLY
FTDEEVDELYR	TDEEVDELY
TPSPIIQQL	TPSPIIQQL
FPEIDLEKY	FPEIDLEKY
EEAENTLQSFR	EAENTLQSF
LPALPLAEL	LPALPLAEL
MPEQIVIHAL	MPEQVIHAL
IPIPFYLSVY	IPIPYLSVY
TPADVFIVF	TPADVFIVF
MPNVKVAVF	MPNVKVAVF
SPVALNVQY	SPVALNVQY
LPWNITVHF	LPWNITVHF
FALPSELERSY	LPSELERSY
FPSNFIKEL	FPSNFIKEL
VPVMLTEQY	VPVMLTEQY
LPAYPTENF	LPAYPTENF
AIEENNNFSK	IEENNNFSK
TAFYLIENY	TAFYLIENY
LPHAPGVQM	LPHAPGVQM
AVFLLDDK	AVF-LLDDK
LAAADISAYY	LAAADISAY
FPLDVGSIVGY	FPLDSIVGY
TPRIELEEM	TPRIELEEM
TVFDLVEEY	TVFDLVEEY
SALPLYNLY	SALPLYNLY
SAADFFSHY	SAADFFSHY
FAADIISVL	FAADIISVL
SPNAEIHIL	SPNAEIHIL
LPIGDVATQYF	LPIGVATQY
VADPYVVIM	VADPYVVIM
MPLGSAVDIL	MPLGAVDIL
YAFPKEFPY	YAFPKEFPY
MPQGAPRLY	MPQGAPRLY
IPVTIMDVF	IPVTIMDVF
VPLGMTVTF	VPLGMTVTF
IQLVEEELDR	QLVEEELDR
LPHGLIESF	LPHGLIESF
LPMGALPQGPM	LPMGALPQG
EAGEQGDIEPR	EAGEDIEPR
FIWVDGSHVDY	FIWVSHVDY
LPLTHFELY	LPLTHFELY
FPATPLLDY	FPATPLLDY
TAVKIAPRY	TAVKIAPRY
LPVKGFRSY	LPVKGFRSY
ISFNELNDLFK	ISFNLNDLF
NAFWTIPVY	NAFWTIPVY
FPNKQGYVL	FPNKQGYVL
MPVAAREASIY	MPVAEASIY
FPIAEVFTL	FPIAEVFTL
SPIPFPPLSY	SPIPPPLSY
QLEEAEEEAQR	LEEAEEAQR
SPVQLAFSDF	SPVQAFSDF
QPINLIFRY	QPINLIFRY
VPNFIFDEF	VPNFIFDEF
VPIKFIAEF	VPIKFIAEF
LPLLLLLPM	LPLLLLLPM
DASKVVTVF	DASKVVTVF
EALDHMVEY	EALDHMVEY
AVHDITVAY	AVHDITVAY
LPDTRSEAY	LPDTRSEAY
RPSGKGIVEF	RPSGGIVEF
YPYNAPTVKF	YPYNPTVKF
LPDNSLKVF	LPDNSLKVF
FPEYELPEL	FPEYELPEL
FPGPIFHL	FPG-PIFHL
NAFYEHAQTY	NAFYHAQTY
YPDTDVILM	YPDTDVILM
TPFVEGLSY	TPFVEGLSY
FPWDIDEAL	FPWDIDEAL
NPDDVFREF	NPDDVFREF
SPTDVHKQY	SPTDVHKQY
MAFQNDVYEW	MAF-QNDVY
MPSDVLEVT	MPSDVLEVT
YALEEGIVRY	YALEGIVRY
FPVPKPIDY	FPVPKPIDY
DPFIDLNYM	DPFIDLNYM
FPFKPPSIY	FPFKPPSIY
TPHSEIIFY	TPHSEIIFY
TASPVAVSL	TASPVAVSL
NPVGGLLEY	NPVGGLLEY
LPAVVVETF	LPAVVVETF
FPEPLIIPVL	FPEPIIPVL
SVLPFQIYY	SVLPFQIYY
DVDLEFLAK	DVDLEFLAK
NAAFPFLAY	NAAFPFLAY
FPEEVIATIF	FPEEIATIF
SPASDTYIVF	SPASTYIVF
WPLVAALL	WPL-VAALL
FPEGLVIQAY	FPEGVIQAY
DSYVGDEAQSK	YVGDEAQSK
FPHGDLTEF	FPHGDLTEF
RPSVLIVTY	RPSVLIVTY
FPAAPAPKM	FPAAPAPKM
LLQDFFNGK	LLQDFFNGK
MPAAQEGAVAF	MPAAGAVAF
TPLSLFGDTY	TPLSFGDTY
HPWEVMPDLY	HPWEMPDLY
QPLEEIITY	QPLEEIITY
IPNENELQF	IPNENELQF
LPVARFLKY	LPVARFLKY
NAFEHGGEFTY	NAFEHGGEF
MPTDVLEVT	MPTDVLEVT
NPVQALSEF	NPVQALSEF
NAVNLAIKY	NAVNLAIKY
FPAGSVHVNVY	FPAGHVNVY
APWQVVPEL	APWQVVPEL
FPIHVQTSL	FPIHVQTSL
YPAQITPKM	YPAQITPKM
SSEEIESAFR	SSEEIESAF
NPENLATLERY	NPENATLER
FIDASRLVY	FIDASRLVY
AAAALLGSAPY	AALLGSAPY
FPPEANYLF	FPPEANYLF
IPWKHIDYF	IPWKHIDYF
VPFTEQIIQTF	VPFTIIQTF
HIMEIFSTY	HIMEIFSTY
IPEELEFQY	IPEELEFQY
LPNDGDEKY	LPNDGDEKY
AGELTEDEVER	ELTEDEVER
LPVNESFGF	LPVNESFGF
APAFLYDIY	APAFLYDIY
TPVDFFFEF	TPVDFFFEF
IDIIPNPQER	DIIPNPQER
IPKEQGVLSF	IPKEGVLSF
MPVGPDAILRY	MPVGAILRY
DAIPAVEVF	DAIPAVEVF
EPIYIVTEY	EPIYIVTEY
VREEEIEVDSR	EEEIEVDSR
LHVDPENFR	LHVDPENFR
EMEAELEDER	MEAELEDER
FPLEPDDEVF	FPLEDDEVF
TAWLEIMTKY	TAWLIMTKY
LPDEASEAF	LPDEASEAF
NPWDNKAVY	NPWDNKAVY
SPEGRLYQVEY	SPEGYQVEY
FPAEFRDGY	FPAEFRDGY
LPDEIYHVY	LPDEIYHVY
TAHLTFVIDCT	TAHLTFVID
FPVPGSGLVL	FPVPSGLVL
EQVANSAFVER	VANSAFVER
LPLPSPALEY	LPLPPALEY
MAVELPDSF	MAVELPDSF
TAEGIILLF	TAEGIILLF
YPDEYHGEY	YPDEYHGEY
HPIRIADGY	HPIRIADGY
EPWHLDIFEF	EPWHDIFEF
EPWPENATLY	EPWPNATLY
FPDFPTPGVVF	FPDFPGVVF
LPAAGVGDMVM	LPAAGVGDM
LPQDVILKF	LPQDVILKF
DLWLEREVF	DLWLEREVF
LPIPDPGVSV	LPIPPGVSV
MAAALFVLL	MAAALFVLL
DGYDYDGYR	DGYDYDGYR
NIPEIVAVY	NIPEIVAVY
SPDEIVIKF	SPDEIVIKF
YPFKPPKITF	YPFKPKITF
FPEELTQTF	FPEELTQTF
YPSEFATYL	YPSEFATYL
IPFNQALVF	IPFNQALVF
SPIEFLENAY	SPIELENAY
VEIIANDQGNR	IIANDQGNR
SPEELYRVF	SPEELYRVF
DKHIEEVR	DKH-IEEVR
FPEDVVRVIF	FPEDVRVIF
SGKYDLDFK	SGKYDLDFK
HPWFGMEQEY	HPWFMEQEY
KPVYSYVLY	KPVYSYVLY
YPLEDLPSLLY	YPLEDLPSL
NAAQTSVAY	NAAQTSVAY
HPEKLATVL	HPEKLATVL
IPFEFPLHL	IPFEFPLHL
FPALPGSSY	FPALPGSSY
IEVIEIMTDR	EVIEIMTDR
EVNAVVLLY	EVNAVVLLY
MPLGARILF	MPLGARILF
LSQEFEAFFQ	LSQEFEAFF
HPISDHEATL	HPISHEATL
HPLSLTSDQY	HPLSTSDQY
LPQPDVFPLF	LPQPVFPLF
EDQTEYLEER	DQTEYLEER
YPVTPELLERY	YPVTLLERY
FPVSIPAVL	FPVSIPAVL
VALPGVAVSM	VALPVAVSM
MPTIQITAL	MPTIQITAL
SAFPYAHRF	SAFPYAHRF
TPMFVVKAY	TPMFVVKAY
AANPHSFVF	AANPHSFVF
MPSSDTTVTF	MPSSTTVTF
LPMGVVVDY	LPMGVVVDY
MVVDIVQEL	MVVDIVQEL
IPIALSGRDIL	IPIAGRDIL
MLNIVQDSALL	NIVQDSALL
FPEFLGMMAR	FPEFGMMAR
NDEELNKLLGK	NDEELNKLL
MVQPINLIF	MVQPINLIF
DVNAAIATIK	DVNAAIATI
DPFVDRIGY	DPFVDRIGY
IPAPGSGVSF	IPAPSGVSF
HQGVMVGMGQK	GVMVGMGQK
TAIEAQHLL	TAIEAQHLL
LPNDVISSL	LPNDVISSL
HAIQDLLVFY	HAIQDLLVF
LPPGVHISY	LPPGVHISY
YPQDWFQVL	YPQDWFQVL
HPLPGTQLL	HPLPGTQLL
HPVYILKGGY	HPVYLKGGY
MALAVRVVY	MALAVRVVY
VPYEKGFAL	VPYEKGFAL
EPFNRPSTF	EPFNRPSTF
NAITLPEEF	NAITLPEEF
QPWEEIKTSY	QPWEIKTSY
VTLTSEEEAR	TLTSEEEAR
FPYEGGKVF	FPYEGGKVF
HAFVELHEF	HAFVELHEF
APSVVKISY	APSVVKISY
LPTEEQRVY	LPTEEQRVY
EAMRIGAEVY	EAMRGAEVY
FPVEIKSFYM	FPVEIKSFY
TPIQSKEAY	TPIQSKEAY
FAGDDAPRAVF	FAGDPRAVF
YPDINFNRL	YPDINFNRL
LPFSSMPTAY	LPFSMPTAY
IPAAVKLTY	IPAAVKLTY
VPRIAPDVL	VPRIAPDVL
IETIEVMEDR	ETIEVMEDR
NPSPYHLYY	NPSPYHLYY
LPFHFPGSF	LPFHFPGSF
FPIPGEPGF	FPIPGEPGF
FPAAPIPTL	FPAAPIPTL
SAVEVCVVY	SAVEVCVVY
LPNGLDVTF	LPNGLDVTF
LPVDLAEEL	LPVDLAEEL
YPAPERLQEY	YPAPRLQEY
NVVKLLGEQY	NVVKLGEQY
FPVKGLKTGY	FPVKLKTGY
NPVKTIKMF	NPVKTIKMF
NAWNNLEKY	NAWNNLEKY
LPHEIVVNL	LPHEIVVNL
AGFAGDDAPR	AGFADDAPR
APVEVTHNF	APVEVTHNF
EILSEVER	EIL-SEVER
GAAGVHFIY	GAAGVHFIY
NPYTEFKEF	NPYTEFKEF
SITHDIEEK	SITHDIEEK
YPTSIASLAF	YPTSASLAF
EPQHWPVQY	EPQHWPVQY
IPISDYTGY	IPISDYTGY
YPFLLVGDLM	YPFLLVGDL
LPYNHQHEYF	LPYNHQHEY
HPTDITSLDQY	HPTDSLDQY
FPWELDPDW	FPWELDPDW
YPGPASLTQIY	GPASLTQIY
LPIGIPYSISF	LPIGYSISF
GAAAIILTY	GAAAIILTY
LPHQPLATY	LPHQPLATY
MGESDDSILR	MGESDSILR
LPLNTNIRLAY	LPLNIRLAY
NVADLHEKY	NVADLHEKY
LPLDIQIFY	LPLDIQIFY
NALPALLIY	NALPALLIY
YPFESAEAQLL	YPFEAEAQL
FHVEEEGK	FHV-EEEGK
FPSEYVPTVF	FPSEVPTVF
ETIEQEKR	ETI-EQEKR
TPTPFFHTF	TPTPFFHTF
EPMNPIKQY	EPMNPIKQY
FPFHEVIQEF	FPFHVIQEF
MPTVHYEF	MPT-VHYEF
FAVDLEHHSY	FAVDEHHSY
FHPIQGHR	FHP-IQGHR
NPISTVTEL	NPISTVTEL
HPIDGFLQSL	HPIDFLQSL
HVIDVKFLY	HVIDVKFLY
NPNSPSITY	NPNSPSITY
YAQDEHLITF	YAQDHLITF
EITALAPSTMK	TALAPSTMK
SPFFERSGLAY	SPFFERSGL
TAAAVVGLLY	TAAAVGLLY
LPYPDPAIAQF	YPDPAIAQF
YPLDLLLKL	YPLDLLLKL
DPLYKENIM	DPLYKENIM
AAIGLVIYY	AAIGLVIYY
HFSVEGQLEFR	FSVEGQLEF
FPSIYDVKY	FPSIYDVKY
KESYSVYVYK	KESYSVYVY
HPMAYQLQL	HPMAYQLQL
TQAEDMLVSY	QAEDMLVSY
NAFDVFAAY	NAFDVFAAY
TPFLYDLVM	TPFLYDLVM
NPTDAFTVF	NPTDAFTVF
VVDLMAHMASK	DLMAHMASK
VPVGEKTTY	VPVGEKTTY
GGNFGFGDSR	GNFGFGDSR
DPFSFDGPEIM	DPFSDGPEI
TPTGVYNYF	TPTGVYNYF
LPPPPPGSF	LPPPPPGSF
YPASTVQIL	YPASTVQIL
DPFPDHVVF	DPFPDHVVF
LDPVLQNPL	LDPVLQNPL
FPHSMEPQL	FPHSMEPQL
TPALVNAAVTY	TPALAAVTY
PVATVLTDM	PVATVLTDM
DPFVDRIGYF	DPFVDRIGY
FPEGLFYEF	FPEGLFYEF
MPQGGGQHY	MPQGGGQHY
LPAFLDNHNY	LPAFDNHNY
LPYSEYFEYF	LPYSEYFEY
EIIDLVLDR	EIIDLVLDR
SPVFMQPVY	SPVFMQPVY
LPTFQSPEF	LPTFQSPEF
MPEEKLVEAL	MPEELVEAL
LPHDPDLAY	LPHDPDLAY
LPFFNDRPW	LPFFNDRPW
NPTDISYVY	NPTDISYVY
EPSFITESY	EPSFITESY
LPYKITAEEMY	LPYKTAEEM
HAIPPTLAM	HAIPPTLAM
LPPEIFGDAL	LPPEFGDAL
APPSSPKVTY	PPSSPKVTY
TALASVVAM	TALASVVAM
FPQTALVSF	FPQTALVSF
GGVVGIKVDK	GVVGIKVDK
YPQEVIPTF	YPQEVIPTF
APIRPDIVNF	APIRDIVNF
YPVDLGDKF	YPVDLGDKF
FPISDDRNSSV	FPISDRNSS
SPFRFEISF	SPFRFEISF
LPSEIEVKY	LPSEIEVKY
DLSLEEIQK	DLSLEEIQK
HPDEPLYSF	HPDEPLYSF
FPYKNCKTDF	FPYKCKTDF
FPEPLIIPVLY	FPEPIIPVL
HPIKQVDVL	HPIKQVDVL
LLKVLSFTHPT	LLKVLSFTH
LPLISVAL	LPL-ISVAL
QPGVLIQVY	QPGVLIQVY
LPIGGLAEF	LPIGGLAEF
RPVNVVNVY	RPVNVVNVY
MDNYSTGYD	MDNYSTGYD
FNVWDTAGQEK	NVWDAGQEK
PPEVTVFPKE	PPEVTVFPK
HPQIIIRAF	HPQIIIRAF
EENSRISITF	EENSISITF
LPFATPEEF	LPFATPEEF
IPAATTIAY	IPAATTIAY
DVFTVVISY	DVFTVVISY
YPLEDATHIAL	YPLETHIAL
LPSTTIVSM	LPSTTIVSM
MPYLEHESF	MPYLEHESF
HVGPFIDSY	HVGPFIDSY
IDEPLEGSEDR	EPLEGSEDR
SPPKDVESY	SPPKDVESY
LPAPPFIAF	LPAPPFIAF
IPSKRLVTSF	IPSKLVTSF
FPVAGQKLIY	FPVAQKLIY
FPEISTRPPL	FPEITRPPL
LPQEAFEKY	LPQEAFEKY
TPSPDIIVL	TPSPDIIVL
MPSVKVSVF	MPSVKVSVF
LPINHQIIY	LPINHQIIY
LPGLPAPSM	LPGLPAPSM
TPAQFDADELR	TPAQDADEL
SAVDVHINM	SAVDVHINM
TAWDEADVRF	TAWDADVRF
FPQFEPQRY	FPQFEPQRY
VSFELFADK	VSFELFADK
HGESAWNLENR	SAW-NLENR
EAFLNNQY	EAF-LNNQY
NPWDDKLIF	NPWDDKLIF
NPVSWVESF	NPVSWVESF
IAMALEVTY	IAMALEVTY
IPLPLIKSY	IPLPLIKSY
SPQEFIHEL	SPQEFIHEL
NVVAVIVAF	NVVAVIVAF
APWEVLVTY	APWEVLVTY
EPDFVAKFY	EPDFVAKFY
APFSKVITF	APFSKVITF
MALLVPLVY	MALLVPLVY
VPEEGGATHVY	VPEEATHVY
TAISLFYEL	TAISLFYEL
LALVTLLSF	LALVTLLSF
HPALAIPEL	HPALAIPEL
IREEYPDR	IRE-EYPDR
VPKEDYYFI	VPKEDYYFI
ISFDEFIK	ISF-DEFIK
FPWEVPKKLKY	FPWEVPKKL
YPNGVVVHY	YPNGVVVHY
YAFDFARQS	YAFDFARQS
FPVPPLLY	FPV-PPLLY
FPVIYDVKY	FPVIYDVKY
EALAGLLVTY	EALALLVTY
IPFLPLEY	IPF-LPLEY
HPSQTVELF	HPSQTVELF
FPVEIKSFY	FPVEIKSFY
NALPDTLKVTY	LPDTLKVTY
NPHNDIQAF	NPHNDIQAF
EVFEDAAEIR	EVFEAAEIR
DAWIEHDVW	DAWIEHDVW
GAMGIMLVY	GAMGIMLVY
MPTPVIKAF	MPTPVIKAF
HPAARDRQF	HPAARDRQF
IIHEIAVLEL	IIHEAVLEL
FPTYPVPHY	FPTYPVPHY
PPDPTKPDY	PPDPTKPDY
FAFEHSEEY	FAFEHSEEY
SPVDVLQIF	SPVDVLQIF
DAFEFHEAF	DAFEFHEAF
YPNPKPEVL	YPNPKPEVL
MPEPQAPGRYF	MPEPQAPGR
FPNIVIKGSEL	FPNIKGSEL
SPVSFIATY	SPVSFIATY
HHPAAAAAY	HHPAAAAAY
IPHSFALISY	IPHSALISY
LGIHEDSTNR	LGIHDSTNR
LPRTDYSF	LPR-TDYSF
EAWLEMNPGY	EAWLMNPGY
FPFPKPDLIF	FPFPPDLIF
SAESKAVQEL	SAESAVQEL
LPLEEAYRF	LPLEEAYRF
EATTEFSVDAR	EATTSVDAR
SPEDDLTDF	SPEDDLTDF
NAIVAVISY	NAIVAVISY
LPVIFLSIF	LPVIFLSIF
SSFPTVVIY	SSFPTVVIY
IPIEPDYKF	IPIEPDYKF
AAVQESARI	AAVQESARI
LDPHLVLDQLR	DPHLVLDQL
LPTEEEWEF	LPTEEEWEF
LPLQDELAF	LPLQDELAF
IPIGGGTSVSY	IPIGTSVSY
APAPTAVVL	APAPTAVVL
FPDLFSEQL	FPDLFSEQL
NPADSISHVAY	NPADSHVAY
HPLDLRVQF	HPLDLRVQF
LPSPVTAQKY	LPSPTAQKY
LPADITEDEF	LPADTEDEF
FPGQLNADLRK	FPGQLNADL
NPASRLTAL	NPASRLTAL
SADQVALVY	SADQVALVY
FHHTIGGSR	FHHTIGGSR
NAYQELLQHY	NAYQLLQHY
IPTKQTQTF	IPTKQTQTF
HLPSDFTPAVH	LPSDFTPAV
HGVLLEVQY	HGVLLEVQY
FPQHTIASL	FPQHTIASL
DLLDHISSP	DLLDHISSP
VPVWIIHYY	VPVWIIHYY
FPGPLLVEL	FPGPLLVEL
FVSGVKIFY	FVSGVKIFY
YADFTLLSI	YADFTLLSI
VPVDLQHQF	VPVDLQHQF
EPTDASLKNF	EPTDSLKNF
HPLGIVQGF	HPLGIVQGF
TVTEVLLKY	TVTEVLLKY
KTVEDLDGL	KTVEDLDGL
WPLLEIHQY	WPLLEIHQY
QPAIIDGELY	QPAIDGELY
RPVEEIVTF	RPVEEIVTF
TLVLLMGK	TLV-LLMGK
LDIDSPPITAR	IDSPPITAR
YPAAVPQAL	YPAAVPQAL
FPQLDSTSF	FPQLDSTSF
LPAPGVPAW	LPAPGVPAW
IPEGEILVITY	IPEGLVITY
HPDGVIPVL	HPDGVIPVL
LPLPNDKTLLY	LPNDKTLLY
DQVANSAFVER	VANSAFVER
FPYYPSPGVLF	FPYYPGVLF
EPIYIITEY	EPIYIITEY
NAFKEITTM	NAFKEITTM
LPIKDGKLVF	LPIKGKLVF
DAADIRFVY	DAADIRFVY
MPEDVKNFYL	MPEDVKNFY
LPVIIFTTF	LPVIIFTTF
FPQIEINKM	FPQIEINKM
IPISLHTSL	IPISLHTSL
LPFEKSTIM	LPFEKSTIM
IPKYLEIEI	IPKYLEIEI
YPEFARKAL	YPEFARKAL
NFGIGQDIQPK	FGIGDIQPK
GSGTAEVELK	SGTAEVELK
LPYNDYFEY	LPYNDYFEY
LPLFPEPLHVF	LPLFPLHVF
LPYKATENDIY	LPYKENDIY
FAYDGKDYI	FAYDGKDYI
HPFKFSDHY	HPFKFSDHY
RAFDQGADAIY	FDQGADAIY
FAEAFEAIPR	FAEAEAIPR
FPASFPNRQY	FPASPNRQY
TATQLAVNK	TATQLAVNK
FLWPEAFLY	FLWPEAFLY
TPWPHIVEF	TPWPHIVEF
KPLLSEIRF	KPLLSEIRF
YPSETTVKYVF	YPSETTVKY
QPNPLPLRL	QPNPLPLRL
FPQEFIICF	FPQEFIICF
NPVEYSIVM	NPVEYSIVM
EKVESELR	EKV-ESELR
ISEQFTAMFR	ISEQFTAMF
SPVTTIVGY	SPVTTIVGY
FPNALFVVY	FPNALFVVY
YPYPPPPPEF	YPYPPPPEF
EDAANNYAR	EDAANNYAR
DAYPEIEKF	DAYPEIEKF
LPTAVIANL	LPTAVIANL
FPFAVANQL	FPFAVANQL
QAVADAVTY	QAVADAVTY
IPTPPLPSY	IPTPPLPSY
AYDATHLVK	AYDATHLVK
VPSGLIVDY	VPSGLIVDY
MPVLEQSVL	MPVLEQSVL
NPVDIVSTL	NPVDIVSTL
LPYTVVIHY	LPYTVVIHY
FPFEDITQH	FPFEDITQH
MPNSPAPHF	MPNSPAPHF
FPHLPGKTFVY	FPHLPGKTF
NPTQSDSGIY	NPTQDSGIY
IPQNFIADY	IPQNFIADY
MPVEKNITL	MPVEKNITL
IPTCSNIQY	IPTCSNIQY
LPVDFVECL	LPVDFVECL
MPLEDMNEF	MPLEDMNEF
LPFDCTQAL	LPFDCTQAL
FPSAKDPTW	FPSAKDPTW
LPVPVIPSF	LPVPVIPSF
LPSHVVTML	LPSHVVTML
EAFQLFDR	EAF-QLFDR
FPEEVIATI	FPEEVIATI
LPNFGFVVF	LPNFGFVVF
SPSVKTSLVF	SPSVTSLVF
LPFDKETGF	LPFDKETGF
WPAEYIIVF	WPAEYIIVF
IPSTVKTNLY	IPSTVKTNL
FPYPFQVVY	FPYPFQVVY
SAAPFFVLF	SAAPFFVLF
LPGEDWVFV	LPGEDWVFV
NPVTVINEY	NPVTVINEY
TASAVVQHM	TASAVVQHM
MPNGTVQRF	MPNGTVQRF
LALFSETAY	LALFSETAY
DALVITHY	DAL-VITHY
FPFLSGDNQHY	FPFLDNQHY
DPFRDLHSL	DPFRDLHSL
TPMIKENSGF	TPMIENSGF
LPSLSAHEL	LPSLSAHEL
SPFHDIPIY	SPFHDIPIY
HPEASIQAVF	HPEAIQAVF
TAAETHYTY	TAAETHYTY
LPVEEFNEL	LPVEEFNEL
TPAGVQVIL	TPAGVQVIL
DAGPLLISLK	DAGPLLISL
TVSDAILRY	TVSDAILRY
RPFAGFEDF	RPFAGFEDF
IPDQVIRVF	IPDQVIRVF
YPGPGNHFW	YPGPGNHFW
LPSSFVEKL	LPSSFVEKL
FPMEIRQYL	FPMEIRQYL
FPEALARLL	FPEALARLL
APAPVQPPM	APAPVQPPM
SPFQPHVPY	SPFQPHVPY
QPFQVAEVF	QPFQVAEVF
YPIALTRAEM	YPIATRAEM
LPNNIVDVW	LPNNIVDVW
SALGSAPLPAL	SALGPLPAL
MPIKLKIGL	MPIKLKIGL
IPIAGRDITY	IPIARDITY
HADGTIVRY	HADGTIVRY
LPHFFPWSF	LPHFFPWSF
SPLAFEHVM	SPLAFEHVM
YAWRPVFDEY	YAWRVFDEY
SAANIQPIF	SAANIQPIF
HPVHPDIKL	HPVHPDIKL
IPWLNEPSF	IPWLNEPSF
LLLPGELAK	LLLPGELAK
EAWHELAELY	EAWHLAELY
HPNLVVGGTY	HPNLVGGTY
YPVEIHEY	YPV-EIHEY
IPVIVTEQY	IPVIVTEQY
FPEIHVAQY	FPEIHVAQY
TPAEIREEF	TPAEIREEF
LPNLITPRY	LPNLITPRY
IVSQIAVAY	IVSQIAVAY
LPDTLKVTY	LPDTLKVTY
MPAVKAIIYQY	MPAVKAIIY
VPWHEEVVQF	VPWHEVVQF
GYSFTTTAER	YSFTTTAER
YPFKPPKVTF	YPFKPKVTF
NEENIFII	NEE-NIFII
SESPKEPEQLR	SPKEPEQLR
NAVDALIDSM	NAVDLIDSM
VELQELNDR	VELQELNDR
TACAPVSHY	TACAPVSHY
ATADTVIIY	ATADTVIIY
FALVFPLMY	FALVFPLMY
LPAKVEFGVY	LPAKEFGVY
VPSPAQIMY	VPSPAQIMY
MPIGPDVSL	MPIGPDVSL
IPDDLKQLY	IPDDLKQLY
SGVSLAALK	SGVSLAALK
EAKVKFEERYK	EAKVKFEER
EPLHFSKFL	EPLHFSKFL
IPVDLVKSSF	IPVDVKSSF
SPAPVPVTY	SPAPVPVTY
MPTVDEDLF	MPTVDEDLF
KPALAQPAL	KPALAQPAL
VPIKEQILY	VPIKEQILY
FAKSVSFSDVF	FAKSFSDVF
LPLPVVQLL	LPLPVVQLL
SPDATIRIW	SPDATIRIW
MSFEWPWQY	MSFEWPWQY
SALPTVVAY	SALPTVVAY
FPIPLINRL	FPIPLINRL
IPYPLPPNY	IPYPLPPNY
YPDRIMNTF	YPDRIMNTF
GAHGIIVVY	GAHGIIVVY
MANIPLPEY	MANIPLPEY
EVLGLILRY	EVLGLILRY
YPLDLEGGSEY	YPLDGGSEY
LPTIAFAF	LPT-IAFAF
TPDEIDHVF	TPDEIDHVF
HPLPETAVRGY	HPLPETAVR
APFDWKILY	APFDWKILY
FPRHIEPEL	FPRHIEPEL
GPGGLSALL	GPGGLSALL
TPLVDPSVY	TPLVDPSVY
FPAPAKAVVY	FPAPKAVVY
AGLQFPVGR	AGLQFPVGR
NPFELAFSL	NPFELAFSL
NPADITVLF	NPADITVLF
NPDEVHAIL	NPDEVHAIL
MAAAAAAAAEQ	MAAAAAAAA
FPAEPLEL	FPA-EPLEL
VAAPLFELY	VAAPLFELY
FPQYPDKEL	FPQYPDKEL
HPSNVLHFF	HPSNVLHFF
FPTVQHQEL	FPTVQHQEL
LSKEDIER	LSK-EDIER
LPDERTISL	LPDERTISL
DPNFVPAAF	DPNFVPAAF
VEFMDDTSR	VEFMDDTSR
MPQMKKILKM	MPQMKKILK
MPSQVVKGGAF	MPSQKGGAF
MPEDLVEAL	MPEDLVEAL
FPQPPQQSY	FPQPPQQSY
IAMDLILKM	IAMDLILKM
VPFKQGMEY	VPFKQGMEY
YPTQPGQGY	YPTQPGQGY
FPAGKVPAF	FPAGKVPAF
TPAGVVNKY	TPAGVVNKY
MPAEIVELH	MPAEIVELH
VPPLFVIEF	VPPLFVIEF
IGAEVYHNLK	IGAEVYHNL
DMALSDVT	DMA-LSDVT
SPPQDVESY	SPPQDVESY
APLPGNVLVY	APLPNVLVY
IPLDGETWSY	IPLDETWSY
APLKLQMEF	APLKLQMEF
HPVDFLDAF	HPVDFLDAF
EPFLFVDEF	EPFLFVDEF
FPLLPQDVHLL	FPLLDVHLL
SPVLNIVLF	SPVLNIVLF
VPLPAGWEM	VPLPAGWEM
LPLTSLVITY	LPLTLVITY
APWFDPAIF	APWFDPAIF
IPGFARSCY	IPGFARSCY
HPRIITEGF	HPRIITEGF
IPSELFSSF	IPSELFSSF
NVHDIMVSF	NVHDIMVSF
LPINDPLQTVY	LPINLQTVY
SPMLYFLYVY	SPMLFLYVY
IWHHTFYNELR	HHTFYNELR
TPSPPEVVY	TPSPPEVVY
GDEELDSLIK	DEELDSLIK
MALADSAI	MAL-ADSAI
MPFRDLILF	MPFRDLILF
TAAPVVPEL	TAAPVVPEL
YPNIGGIIRY	YPNIGIIRY
LPLLSPVTF	LPLLSPVTF
IPYHSEVPVSL	IPYHVPVSL
TPFKGGTLF	TPFKGGTLF
IPICHGNLIF	IPICGNLIF
FVNPGVVEF	FVNPGVVEF
NVIHNLATY	NVIHNLATY
HPDPTRLLLF	HPDPTRLLL
EALSLAHTY	EALSLAHTY
PELAKSAPAPK	LAKSAPAPK
IPIPTLKDF	IPIPTLKDF
FPTISLEF	FPT-ISLEF
YSFLDKMSF	YSFLDKMSF
KPYASKVFF	KPYASKVFF
FPVEVNTVL	FPVEVNTVL
SNLENIDFK	SNLENIDFK
EAASVPVVY	EAASVPVVY
HPDVLPFAL	HPDVLPFAL
IPIDNGSNM	IPIDNGSNM
VVPTAILAF	VVPTAILAF
NPIINTHSF	NPIINTHSF
NPLQKDPQY	NPLQKDPQY
ADHGEPIGR	ADHGEPIGR
IPDKFVVGY	IPDKFVVGY
LPKNDLITY	LPKNDLITY
NVVQLIMDAY	NVVQIMDAY
LPSHLNISY	LPSHLNISY
YPLEDLPSL	YPLEDLPSL
HYTEAIKR	HYT-EAIKR
FPRKDKSIM	FPRKDKSIM
GDLGIEIPAEK	LGIEIPAEK
QEKIVQCQKA	QEKIVQCQK
IPYSEPMPLSF	IPYSMPLSF
FADLSEAANR	FADLEAANR
APPPPPPPP	APPPPPPPP
MPNENIPEL	MPNENIPEL
YKCVSCTKTF	KCVSCTKTF
NAWADIERF	NAWADIERF
TPIVNSVQEF	TPIVSVQEF
VPFSIFDEF	VPFSIFDEF
DIDIHEVR	DID-IHEVR
EPVTYDIDDY	EPVTDIDDY
VLETAEDIQER	LETADIQER
SPIFDVDVAF	SPIFVDVAF
YPIDLAGLLQY	YPIDGLLQY
DPSLLHLL	DPS-LLHLL
MPELVDFRQY	MPELDFRQY
TAWLDGKHVVF	TAWLKHVVF
EAIEQILKY	EAIEQILKY
FPANNIVKF	FPANNIVKF
TPRPANRIY	TPRPANRIY
MPADTNKAF	MPADTNKAF
TAAGLMHTF	TAAGLMHTF
LGAPDELLAF	LGAPELLAF
FVSESIISY	FVSESIISY
SPGAAGYDLY	SPGAGYDLY
LPFHPYVENG	LPFHPYVEN
LPVPAFNVI	LPVPAFNVI
VPAEVTVIL	VPAEVTVIL
LPYFDRLDY	LPYFDRLDY
IARDEGGKAF	IARDGGKAF
MPQVAPDLY	MPQVAPDLY
IPISPISPAF	IPISISPAF
RPKILSMINY	RPKISMINY
APWIESQDWAY	APWIQDWAY
LPSDFTPAVH	LPSDFTPAV
IPFAAPTAL	IPFAAPTAL
VPVEDLPYT	VPVEDLPYT
YPLEVTKLIY	YPLETKLIY
MPEKEPSVL	MPEKEPSVL
HALALAWTF	HALALAWTF
HPIQTQAQY	HPIQTQAQY
YAIDNPLHY	YAIDNPLHY
VENQIEKVF	VENQIEKVF
EDMAALEK	EDM-AALEK
DMGFTEEEFKR	MGFTEEEFK
LPEARGRAGL	LPEAGRAGL
RPTDVAISF	RPTDVAISF
EVFPLAMNY	EVFPLAMNY
VPCDSNEANEM	VPCDEANEM
YMFVDENTF	YMFVDENTF
TFTQQEIEF	TFTQQEIEF
FPLPGLPDF	FPLPGLPDF
IPFRPSIQF	IPFRPSIQF
DAVAIVLTY	DAVAIVLTY
IPIHADPRL	IPIHADPRL
LPFDGSPKITY	LPFDPKITY
FPNITLKII	FPNITLKII
IQKFPVGR	IQK-FPVGR
NPGEIFIIL	NPGEIFIIL
MPWVQETLAAN	MPW-VQETL
LPAPPKIYF	LPAPPKIYF
IGGIGTVPVGR	GGIGVPVGR
FPSEYVPTV	FPSEYVPTV
FPDETHERY	FPDETHERY
TPGGTRIIY	TPGGTRIIY
YPGQPHPAL	YPGQPHPAL
IPLALEGKDLL	LALEGKDLL
QAIEDMVGY	QAIEDMVGY
LPDPNLITF	LPDPNLITF
SPVNSSKQPSY	SPVNKQPSY
PVPVLVEDT	PVPVLVEDT
YVHDDGRVSY	YVHDGRVSY
YPKSNSGDKY	YPKSSGDKY
TAWEDYIWF	TAWEDYIWF
VPVPPILGF	VPVPPILGF
LGIHEDSQNR	LGIHDSQNR
IDCLSQKQF	IDCLSQKQF
FPDAIRLRF	FPDAIRLRF
LPFDLRIPF	LPFDLRIPF
MPQSMPEYAL	MPQSPEYAL
EVVEEAENGR	EVVEAENGR
LPTEKEVAL	LPTEKEVAL
IPVFLRHAEL	IPVFRHAEL
FPEEDKKTY	FPEEDKKTY
LPALRSIGL	LPALRSIGL
NPYHVVILF	NPYHVVILF
DPGSVIVAF	DPGSVIVAF
FPKNDFVSF	FPKNDFVSF
IEEELGDEAR	IEEEGDEAR
HPYQPDPKM	HPYQPDPKM
ESYSVYVYK	ESYSVYVYK
TPIPGTIEM	TPIPGTIEM
EQLAIAEFAR	LAI-AEFAR
YPVFPWIIHDY	FPW-IIHDY
HPELHDIPIYY	HPELDIPIY
PAGVVNKY	PAG-VVNKY
TPLDEKSLAL	TPLDKSLAL
CPPGFTGSY	CPPGFTGSY
VPQVSTPTL	VPQVSTPTL
AFADLCIGIY	FADLCIGIY
MPVFPDFKM	MPVFPDFKM
TPFDVEDTF	TPFDVEDTF
MPTTGINEY	MPTTGINEY
LPEEEQQRVL	LPEEQQRVL
ADEGISFR	ADE-GISFR
YPAGFPMGY	YPAGFPMGY
YPFSSEQKW	YPFSSEQKW
ESEAVEWQQK	SEAVEWQQK
FPASPPKGYFL	FPASPPKGY
IPAESYTFF	IPAESYTFF
SAWSFITTF	SAWSFITTF
SPQVIKSLY	SPQVIKSLY
HIYYITGETK	IYYITGETK
LPNTDVPIL	LPNTDVPIL
LMIEMDGTENK	IEMDGTENK
NAFAEPGRVPF	FAEPGRVPF
YPRDNPELI	YPRDNPELI
FPLEAITAF	FPLEAITAF
RPFASGANFEY	FASGANFEY
SADLRSPVY	SADLRSPVY
LPIGDVATQY	LPIGVATQY
QPLEDLASF	QPLEDLASF
PEPAKSAPAPK	EPAKAPAPK
FAVTEYPTLKF	FAVTEYPTL
EPFRLGIRF	EPFRLGIRF
DPFLNSGTY	DPFLNSGTY
YALYDATYETK	YAL-YDATY
LPQSMVFEY	LPQSMVFEY
GNPQKAILY	GNPQKAILY
TPSEPHPVL	TPSEPHPVL
IPAESYTF	IPA-ESYTF
LIEVDDER	LIE-VDDER
FPSPIRLEF	FPSPIRLEF
DAISGIGTDEK	DAISGTDEK
FPYQDKLVGY	FPYQKLVGY
MPQEKSPGY	MPQEKSPGY
FEDENFILK	FEDENFILK
EAAVAIKAM	EAAVAIKAM
PTFGAADWEVF	FGAADWEVF
EAFSPVYKY	EAFSPVYKY
SPAQEDGKVY	SPAQDGKVY
MFCQAARVDL	FCQAARVDL
DAGPPTHAF	DAGPPTHAF
PAQYPPPP	PAQ-YPPPP
TVIDEVRTGTY	TVIDRTGTY
TPSSDVLVF	TPSSDVLVF
LAVNMVPFPR	LAVNVPFPR
HFNAPSHIR	HFNAPSHIR
TVLELVTQY	TVLELVTQY
YPLTIATLL	YPLTIATLL
QPMEVQEGY	QPMEVQEGY
ASTSSNSASSF	TSSNSASSF
AVFPSIVGRPR	FPSIVGRPR
VRVELSNGEK	RVELSNGEK
FDDAVVQSDMK	FDDAVQSDM
RPFEENGACKY	RPFEGACKY
TPVDDRISL	TPVDDRISL
FPEQIAEKL	FPEQIAEKL
