Data	Data aligned
LPIRYQTPAI	LPIRYQTPA
KPVGWAMSF	KPVGWAMSF
TPNYMKLLVY	TPNMKLLVY
LPVNVAFEL	LPVNVAFEL
EPVPLTVKM	EPVPLTVKM
FPYVMGDVEL	FPYMGDVEL
FPYSIPATLL	FPYSIPATL
MSYAMCTNTF	MSYMCTNTF
CPNSYDSIM	CPNSYDSIM
EPISYDPKF	EPISYDPKF
KPTTFMLKY	KPTTFMLKY
KPKALSEAF	KPKALSEAF
CPFLFLIVL	CPFLFLIVL
EQFWCGIPY	EQFWCGIPY
QTSTLYDFY	QTSTLYDFY
MYMALIAAF	MYMALIAAF
FVHSGFIYF	FVHSGFIYF
YPMSIPATLF	YPMSIPATL
TAEAGGRAY	TAEAGGRAY
YPLAIPVTM	YPLAIPVTM
NPITLTAAL	NPITLTAAL
ETACLSKAY	ETACLSKAY
IPYSRVNHA	IPYSRVNHA
TPVWHVTSA	TPVWHVTSA
ELNITSATY	ELNITSATY
FAGPVSQHNY	FAGVSQHNY
EIKFNDITF	EIKFNDITF
MAGCGYLMF	MAGCGYLMF
QPLIGSRAF	QPLIGSRAF
LPGCSFSIF	LPGCSFSIF
QVIEYLKPY	QVIEYLKPY
MALSIVSLF	MALSIVSLF
FPAGLTYSQL	FPALTYSQL
FATTPVCEY	FATTPVCEY
TPARVTGGVF	TPAVTGGVF
MNNGGDAMY	MNNGGDAMY
TLASIGTAF	TLASIGTAF
KPNELSLAL	KPNELSLAL
ASPVAQSYL	ASPVAQSYL
TPTHLSLAI	TPTHLSLAI
WAYHGSYEA	WAYHGSYEA
KPVSDLYTSM	KPVDLYTSM
YANMWSLMY	YANMWSLMY
VPNYNLIVM	VPNYNLIVM
YQYPRDTHY	YQYPRDTHY
EEVWRDPYL	EEVWRDPYL
YPWAIFHPH	YPWAIFHPH
FSLPSSSSY	FSLPSSSSY
SASLAALFY	SASLAALFY
LPDALLFTL	LPDALLFTL
GYSFSIPGY	GYSFSIPGY
QPYPQPQPQY	QPYQPQPQY
APSTGSASSM	APSGSASSM
SPRPEMQEF	SPRPEMQEF
TPQDNQLAY	TPQDNQLAY
FPVRPQVPW	FPVRPQVPW
IPITAAAWY	IPITAAAWY
MPDCGMSVLA	MPDCGMSVL
TFMYVFSTF	TFMYVFSTF
YPQPQLPY	YP-QPQLPY
YARAGSSSH	YARAGSSSH
LPYPQPQLPY	LPYQPQLPY
RPLMESELVI	RPLESELVI
MPIEPGDIGC	MPIEPGDIG
TPRIEGGTF	TPRIEGGTF
LAIMAVFKM	LAIMAVFKM
YPNSSDLDM	YPNSSDLDM
IPIPSSWAF	IPIPSSWAF
LPMIIGEPI	LPMIIGEPI
KPVDTSNSF	KPVDTSNSF
FPANINDKQI	FPAINDKQI
IVHVDHECF	IVHVDHECF
APAMGMNAY	APAMGMNAY
MPSACANGW	MPSACANGW
EPLAVIASL	EPLAVIASL
YPLSIPATLF	YPLSIPATL
MSPALFFTF	MSPALFFTF
LPFHNVHPL	LPFHNVHPL
MLWMAEIPL	MLWMAEIPL
WATLLSLTF	WATLLSLTF
TPNQPSAEF	TPNQPSAEF
FPASFFIKL	FPASFFIKL
IIGFFLVTY	IIGFFLVTY
MSFRDLGRVM	MSFDLGRVM
YADHGANQL	YADHGANQL
MPSLTLACL	MPSLTLACL
NPTNISKCF	NPTNISKCF
MPFAWQFGF	MPFAWQFGF
QGFPWDILF	QGFPWDILF
LPIFSEFVL	LPIFSEFVL
EPLSPDTCLL	EPLSPDTCL
HPAAMPHLL	HPAAMPHLL
VPLPCQLMY	VPLPCQLMY
QPQNGQFIHF	QPQNGQFIH
FTIRDVLAY	FTIRDVLAY
FPVRPQVPM	FPVRPQVPM
LPANLTLMM	LPANLTLMM
ILRPLGIEY	ILRPLGIEY
AVTALTIAY	AVTALTIAY
TAVAPSMTM	TAVAPSMTM
EPEKDIREL	EPEKDIREL
FAFKLSFAI	FAFKLSFAI
RPIFEWIEA	RPIFEWIEA
FPVSIPITAA	FPVSIPITA
CPTQGEAVL	CPTQGEAVL
HVCYFSHPY	HVCYFSHPY
LPVWLAYRVA	LPVWLAYRV
HPGFTVIAL	HPGFTVIAL
YPQSQPQY	YP-QSQPQY
DPRDDLSGM	DPRDDLSGM
LPSIVREAL	LPSIVREAL
IPEPDRQRTP	IPEPDRQRT
FVARIDLGY	FVARIDLGY
RLKTATYTF	RLKTATYTF
FPFVLAAII	FPFVLAAII
IPLQASLPF	IPLQASLPF
YVYFYDLSY	YVYFYDLSY
NPIINTHSFY	NPIINTHSF
FPTSRTTWSI	FPTRTTWSI
IPMVTQMAM	IPMVTQMAM
GPMKLVMAF	GPMKLVMAF
MCISLSTAI	MCISLSTAI
HAEQGLIQY	HAEQGLIQY
YKVASAGISY	KVASAGISY
RPPYSSYGY	RPPYSSYGY
FSVQRNLPF	FSVQRNLPF
YAGPFSQHNY	YAGFSQHNY
LPSCPTNFCIF	LPSPTNFCI
YAYNSSLLY	YAYNSSLLY
YAQMWSLMY	YAQMWSLMY
NPIQLSSYSL	NPILSSYSL
FAAWIQQTY	FAAWIQQTY
WMACNSAAF	WMACNSAAF
MAVGMVSIL	MAVGMVSIL
NAASFAINY	NAASFAINY
MPAYIRNTL	MPAYIRNTL
MSPDNALIY	MSPDNALIY
LPSSSSYSY	LPSSSSYSY
HPNPKGFCDL	HPNKGFCDL
MLVTPSMAM	MLVTPSMAM
QPEKEIPEY	QPEKEIPEY
LPTTITVPV	LPTTITVPV
LAVSGVYPL	LAVSGVYPL
EHFYWGSVF	EHFYWGSVF
APTRVVAAEM	APTVVAAEM
VPMVTQMAM	VPMVTQMAM
DGAEGINPY	DGAEGINPY
TPEGIIPSM	TPEGIIPSM
FPREGVFVF	FPREGVFVF
LFAGSIAAY	LFAGSIAAY
FPFWGCFVS	FPFWGCFVS
MAMTDTTPF	MAMTDTTPF
VATTVITPM	VATTVITPM
YLCEDTITY	YLCEDTITY
FQNVNRITY	FQNVNRITY
QPFLALGFFL	QPFLALGFF
DAMPGVLSY	DAMPGVLSY
SPLPITLKY	SPLPITLKY
YLHRDIFDI	YLHRDIFDI
FPRSAERAG	FPRSAERAG
MIAGVLFTF	MIAGVLFTF
LPLMMLSPL	LPLMMLSPL
MPVTVASAAQ	MPVTVASAA
RVFPGDHFY	RVFPGDHFY
LANWCLLNY	LANWCLLNY
NPDNTIAVI	NPDNTIAVI
IPMVTQLAM	IPMVTQLAM
GPGEVSAAM	GPGEVSAAM
LPIRYQTPAV	LPIRYQTPA
KPTGSASSL	KPTGSASSL
WPLLPHVIF	WPLLPHVIF
TPLISFFGLF	TPLISFFGL
QGFPWDLLF	QGFPWDLLF
MAVLFVVTL	MAVLFVVTL
ETVNFVPNY	ETVNFVPNY
FPWDILFPS	FPWDILFPS
WPALSSIAA	WPALSSIAA
MVRVLTVIKEY	RVLTVIKEY
HPNIEEVAL	HPNIEEVAL
MVASQLARY	MVASQLARY
MLLPTALAF	MLLPTALAF
NPFMIEGLM	NPFMIEGLM
IPATLFVWY	IPATLFVWY
WIFEIATPL	WIFEIATPL
HTAEIQQFF	HTAEIQQFF
FSLTSSSKY	FSLTSSSKY
CPFLFLTVL	CPFLFLTVL
SPADERAVA	SPADERAVA
FPWDILFPT	FPWDILFPT
LVGAAIHPF	LVGAAIHPF
FPVSIPITA	FPVSIPITA
MPTYKHLIMF	MPTYKHLIM
LPTSITVPV	LPTSITVPV
QPYLQLQPFL	QPYLQLQPF
TFMDGTPEL	TFMDGTPEL
FAHDDRYLY	FAHDDRYLY
YLSPFKLTY	YLSPFKLTY
FASASSYAI	FASASSYAI
MPVTVASAA	MPVTVASAA
MPKDGLKVL	MPKDGLKVL
YIFRNTINM	YIFRNTINM
YALATQVEF	YALATQVEF
TTFPVNGGY	TTFPVNGGY
IAVSMANIF	IAVSMANIF
EYSYYSSMY	EYSYYSSMY
MAILGETAW	MAILGETAW
LPHIIDEVM	LPHIIDEVM
FPWDMLFPA	FPWDMLFPA
MPALTIACM	MPALTIACM
YRSDIVGTY	YRSDIVGTY
DISPTNIPL	DISPTNIPL
MPLETQLAI	MPLETQLAI
HPGFTVIALF	HPGFTVIAL
FVFEATKLY	FVFEATKLY
MAMTCIAVG	MAMTCIAVG
YLAGAGLAF	YLAGAGLAF
EMSLADYLY	EMSLADYLY
FPAIFSAEV	FPAIFSAEV
WASRELERF	WASRELERF
MQLQLNCAY	MQLQLNCAY
LPFLKSLAI	LPFLKSLAI
GPMPYMISTY	GPMYMISTY
FPVRPQVPY	FPVRPQVPY
FPCSICLSGL	FPCICLSGL
LPTNAVVKM	LPTNAVVKM
FLLPILSQIYT	LPILSQIYT
DAVEDFLAF	DAVEDFLAF
YPITGVKSL	YPITGVKSL
MLIPTAMAF	MLIPTAMAF
MPFIATPPV	MPFIATPPV
EVVDMLSTY	EVVDMLSTY
FPYTGDPPY	FPYTGDPPY
IPFDDIVRTM	IPFDIVRTM
FPIPSSWAF	FPIPSSWAF
MPVETLFGSY	MPVTLFGSY
FVHDSVQYF	FVHDSVQYF
TPNYMKLLV	TPNYMKLLV
TPTVPSSSF	TPTVPSSSF
HAHWTEAKM	HAHWTEAKM
MPGVLSYVI	MPGVLSYVI
KVFFGPIYY	KVFFGPIYY
FPAQPGLTSA	FPAQPGLTS
HPIMYYTKF	HPIMYYTKF
LPQIGGEAI	LPQIGGEAI
LAILFEEVM	LAILFEEVM
LANETTQAL	LANETTQAL
YPIVKGFAV	YPIVKGFAV
TIMAAILAY	TIMAAILAY
SVKERGPAY	SVKERGPAY
LPYSQPQPF	LPYSQPQPF
MPVGGQSSF	MPVGGQSSF
LPESDLDKVY	LPEDLDKVY
VPDIKLDAVL	VPDKLDAVL
APYFATVRL	APYFATVRL
CPNCYDSVM	CPNCYDSVM
EFIYWDWLY	EFIYWDWLY
YPFYVSPTEM	YPFVSPTEM
QPFPSQQPYL	QPFPSQQPY
ITASKDLCF	ITASKDLCF
MPREDAHFI	MPREDAHFI
LPVCQSSSM	LPVCQSSSM
EPHQLAETI	EPHQLAETI
LPNVDLTTM	LPNVDLTTM
FPVRPQVPV	FPVRPQVPV
WFYDNDNPY	WFYDNDNPY
MIAGVFFTF	MIAGVFFTF
YPLAIPVTMT	YPLAIPVTM
QAFEAGIDF	QAFEAGIDF
LPNVQFVDI	LPNVQFVDI
FSIPVTFSY	FSIPVTFSY
FVVDTTPPL	FVVDTTPPL
MALVAFLRF	MALVAFLRF
ITTFFTFAY	ITTFFTFAY
RSLFNTVAVLY	LFNTVAVLY
IPFNVVTAM	IPFNVVTAM
MPAIFFSIV	MPAIFFSIV
MMLPATLAF	MMLPATLAF
MVFQNYALY	MVFQNYALY
FPQPQLPY	FP-QPQLPY
HPASAWTLY	HPASAWTLY
AFDWPELEF	AFDWPELEF
CPFCANKLM	CPFCANKLM
TPVEIVVDM	TPVEIVVDM
IIYERDFSY	IIYERDFSY
EPIEGKVVQY	EPIGKVVQY
RVLDCRTAF	RVLDCRTAF
VPINVAEAY	VPINVAEAY
MPCMINDTHF	MPCINDTHF
VLIEVNPPF	VLIEVNPPF
FALLAGFMAY	FALAGFMAY
YAYEPGSVM	YAYEPGSVM
NPAQEDDQY	NPAQEDDQY
EPIKDMEII	EPIKDMEII
LPDDFMGCVL	LPDFMGCVL
MACHRVLTY	MACHRVLTY
HEGDIVPLF	HEGDIVPLF
IPIPSSWAI	IPIPSSWAI
MPSEDGAEDL	MPSDGAEDL
LPQYFTFDL	LPQYFTFDL
SPMVIATTDM	SPMIATTDM
IAMTDTTPF	IAMTDTTPF
FPVRPQVPF	FPVRPQVPF
FPVRPQVPQ	FPVRPQVPQ
CYMHVSDFY	CYMHVSDFY
LAEQFSGEY	LAEQFSGEY
FVMSCKLLY	FVMSCKLLY
QPFPQPQLPY	QPFQPQLPY
FTLMAAILAY	TLMAAILAY
MFINDVHAL	MFINDVHAL
IAQLNRPAM	IAQLNRPAM
FPGTGSEFV	FPGTGSEFV
KLAEIFQPF	KLAEIFQPF
AMAAAAAPY	AMAAAAAPY
TPYAGEPAPF	TPYGEPAPF
YQYGDNLIL	YQYGDNLIL
LAVSAYTPW	LAVSAYTPW
MPSVIEKMEA	MPSIEKMEA
LLRDKDGVY	LLRDKDGVY
YFNTHDVYF	YFNTHDVYF
YGGPISQHNY	YGGISQHNY
FPYLVAYQA	FPYLVAYQA
LQLTAVFAY	LQLTAVFAY
FAVRPQVPL	FAVRPQVPL
IPVTMTLWYM	IPVTMTLWY
AVHGYYIGY	AVHGYYIGY
LPRRSLKAF	LPRRSLKAF
YAMCTNTFVL	YAMTNTFVL
FPLCANGQVF	FPLANGQVF
LPAMCNVY	LP-AMCNVY
WPTLIGLAM	WPTLIGLAM
NIAAPYLPF	NIAAPYLPF
LAVMGDAAW	LAVMGDAAW
TPPGATDPF	TPPGATDPF
FCVKVLAPY	FCVKVLAPY
LPQIGGEAIF	LPQIGGEAI
MVVKVNAAL	MVVKVNAAL
WCMQHLPSY	WCMQHLPSY
VATTFITPM	VATTFITPM
DFPIFNQRY	DFPIFNQRY
DTFGVIDTM	DTFGVIDTM
MPVTHSSAA	MPVTHSSAA
MPVDHPLSL	MPVDHPLSL
FPEQVSLLM	FPEQVSLLM
LPSDFFPSV	LPSDFFPSV
YGGKKAVTY	YGGKKAVTY
MPSLTMACM	MPSLTMACM
IPKAYAGPF	IPKAYAGPF
QPQQSPQFF	QPQQSPQFF
RPEIDVLPF	RPEIDVLPF
VPLLAIGCY	VPLLAIGCY
YPIVIAPAM	YPIVIAPAM
QPAGGKAEF	QPAGGKAEF
SPSCPLERF	SPSCPLERF
EPIKDMEIIF	EPIDMEIIF
ATFRLECPY	ATFRLECPY
KAWSEGLAM	KAWSEGLAM
MAMALSIVS	MAMALSIVS
MTMITPPTF	MTMITPPTF
TPEGIIPTLF	TPEGIIPTL
MTVFSYKAF	MTVFSYKAF
TPVIVVPVI	TPVIVVPVI
NIMEFCKAY	NIMEFCKAY
IPVTMTLWY	IPVTMTLWY
YAQMWTLMY	YAQMWTLMY
KEDPGDHIF	KEDPGDHIF
KAVHADMGY	KAVHADMGY
HPALVFDIT	HPALVFDIT
HSNLNDTTY	HSNLNDTTY
NATDTWVTY	NATDTWVTY
DPNFHQAVM	DPNFHQAVM
IANQATVLM	IANQATVLM
WALCESITL	WALCESITL
FPQHVITKDV	FPQVITKDV
MLNNSFYYM	MLNNSFYYM
LPDYGELTL	LPDYGELTL
VPFPVVNAM	VPFPVVNAM
HSNLNDATY	HSNLNDATY
FPTQADAIG	FPTQADAIG
IPERSWNSGY	IPESWNSGY
FPVAMLSCL	FPVAMLSCL
IPGDILSII	IPGDILSII
LPTFMTQKAR	LPTFMTQKA
CPLERFAEL	CPLERFAEL
MAILGDTAW	MAILGDTAW
SFSFGGFTF	SFSFGGFTF
IPLSILLTL	IPLSILLTL
LPQTRWQAV	LPQTRWQAV
LPADPASVL	LPADPASVL
RPYGKFRAM	RPYGKFRAM
HPASRLFPF	HPASRLFPF
SPVMGVIGF	SPVMGVIGF
IPVDLVKSSF	IPVLVKSSF
IASAIVLEF	IASAIVLEF
ISCQIYNAL	ISCQIYNAL
KPINLSNSV	KPINLSNSV
RPNITSTAL	RPNITSTAL
LLTQSNAGF	LLTQSNAGF
EIVAEYITY	EIVAEYITY
NLKLYGAEF	NLKLYGAEF
MMMSTAVAF	MMMSTAVAF
IPSYKKLIM	IPSYKKLIM
IPMSTYGWNL	IPMTYGWNL
FPVRPQVPT	FPVRPQVPT
NPIINTHSF	NPIINTHSF
MGMNAYFAY	MGMNAYFAY
MAWGGSYIA	MAWGGSYIA
LPAGSPVAV	LPAGSPVAV
TPVSMTYLY	TPVSMTYLY
LAAPCRNAL	LAAPCRNAL
YVRTNGASY	YVRTNGASY
ITMVNSLTY	ITMVNSLTY
LPTWLGAAI	LPTWLGAAI
YMTLQAVTF	YMTLQAVTF
FPVRPQVPH	FPVRPQVPH
TPEGIIPSMF	TPEGIIPSM
FPHCLAFSI	FPHCLAFSI
NPTSETMYL	NPTSETMYL
LPVYLMTLM	LPVYLMTLM
LPFQNVHPV	LPFQNVHPV
MPSVIEKMET	MPSVIEKME
YPKSNSGDKY	YPKNSGDKY
MPVTAASAA	MPVTAASAA
APDPSRLAF	APDPSRLAF
LPLERAIAV	LPLERAIAV
ELFIAPEGM	ELFIAPEGM
IANQAAVLM	IANQAAVLM
DYAMHGTVF	DYAMHGTVF
IVVDNTSAF	IVVDNTSAF
FVSVYFSDY	FVSVYFSDY
IITANWLPF	IITANWLPF
TLMAAILAY	TLMAAILAY
NFFHASLAY	NFFHASLAY
LPDWATERF	LPDWATERF
QPQPFPSQQPY	QPFPSQQPY
MVLSGTLAY	MVLSGTLAY
WPISAILWF	WPISAILWF
HAQGKALLY	HAQGKALLY
MLAPSTLGY	MLAPSTLGY
EILWDVIPF	EILWDVIPF
QPFRPQQPY	QPFRPQQPY
TPFGQQRVF	TPFGQQRVF
LPLTSLVITY	LPLSLVITY
LVLAVGPAY	LVLAVGPAY
SVFEGIRAY	SVFEGIRAY
YPLSIPATL	YPLSIPATL
LPLIVDTAA	LPLIVDTAA
RPASAWTLY	RPASAWTLY
HPGFTILALF	HPGFTILAL
IHIPGDTLF	IHIPGDTLF
QATAQAAAY	QATAQAAAY
LPPFTQHLL	LPPFTQHLL
IPSTVKTNL	IPSTVKTNL
MPILTLTRAL	MPITLTRAL
VALFSSCPVAY	LFSSCPVAY
APILVVSGI	APILVVSGI
HSEEGSRAY	HSEEGSRAY
TPIAYRNVL	TPIAYRNVL
IPPSFLQAM	IPPSFLQAM
MVDESMMMS	MVDESMMMS
FPGDKTSYWV	FPGDKTSYW
SAYYLDIGF	SAYYLDIGF
LPIRYQTTAT	LPIRYQTTA
HPRHYATVM	HPRHYATVM
MSDIFHALV	MSDIFHALV
IAVSTANIF	IAVSTANIF
IMNEGWASF	IMNEGWASF
MLIPTVMAF	MLIPTVMAF
IAVGMVTLY	IAVGMVTLY
CPKIFNNNY	CPKIFNNNY
VPISHLYIL	VPISHLYIL
CPTQGEATL	CPTQGEATL
FPNITNLCPF	FPNTNLCPF
HPLSHFVNL	HPLSHFVNL
SPSGVYQCAM	SPSVYQCAM
YLKKWLNSF	YLKKWLNSF
NPIVLHNGM	NPIVLHNGM
FPYIMGSVEL	FPYMGSVEL
HPEDTGQVF	HPEDTGQVF
MILPAALAF	MILPAALAF
MPTDMLKLF	MPTDMLKLF
LPEVISTIA	LPEVISTIA
LPTSIVVPI	LPTSIVVPI
YFRNSGMTY	YFRNSGMTY
IANQAAILM	IANQAAILM
EIFPNIKIY	EIFPNIKIY
VLLEARQAY	VLLEARQAY
FPHCLAFSY	FPHCLAFSY
MPDCGMSVL	MPDCGMSVL
MPASWVMRI	MPASWVMRI
FPDIPVNNNI	FPDPVNNNI
NQECWDSVF	NQECWDSVF
FPSQQPYLQL	FPSQPYLQL
LPSLEYGANY	LPSEYGANY
YMYAVSGAL	YMYAVSGAL
QFAGGSFDF	QFAGGSFDF
IPTFLQEAL	IPTFLQEAL
WTIGNRAPY	WTIGNRAPY
FPAPRAETL	FPAPRAETL
QPFLQPQLPY	QPFQPQLPY
TVSPSAPTY	TVSPSAPTY
CPAVAVHDF	CPAVAVHDF
VPLVQQQQF	VPLVQQQQF
NSDPEFNVL	NSDPEFNVL
VPNYNLIIM	VPNYNLIIM
YPTNDIPSLF	YPTNDIPSL
CPMCCSKIL	CPMCCSKIL
IPMTGPLVAG	IPMTGPLVA
YVRGYLRGY	YVRGYLRGY
EGIEGRIAY	EGIEGRIAY
RGRAATMAL	RGRAATMAL
EVFEIIRSY	EVFEIIRSY
LALMATFKM	LALMATFKM
FPSTQRDYY	FPSTQRDYY
HPGSGKTRKY	HPGGKTRKY
VPDADPPIPY	VPDDPPIPY
QPYPQPQPF	QPYPQPQPF
LPESLETLM	LPESLETLM
EFFDGGLTF	EFFDGGLTF
YPIYGLQFH	YPIYGLQFH
HSSVAGGLW	HSSVAGGLW
NSYTLLLAY	NSYTLLLAY
EVDEGSDMM	EVDEGSDMM
LAGPISQHNY	LAGISQHNY
SYGNANVSF	SYGNANVSF
MPLKKQILF	MPLKKQILF
VMETENALF	VMETENALF
YPMSIPATL	YPMSIPATL
IPMATYGWNL	IPMTYGWNL
HTAAPWGSY	HTAAPWGSY
MSSAMSMMH	MSSAMSMMH
ISLEAGQRF	ISLEAGQRF
MPYVFTLLF	MPYVFTLLF
RPEMQEFEY	RPEMQEFEY
KPAPTAPPM	KPAPTAPPM
TPVMSRFAA	TPVMSRFAA
MSNEGSYFF	MSNEGSYFF
IPERSWNTGF	IPESWNTGF
MAVELFQTI	MAVELFQTI
WQFGPSTYY	WQFGPSTYY
WPVLGSEVL	WPVLGSEVL
FVADSTPLY	FVADSTPLY
FPNITLKII	FPNITLKII
SPYYIRKESY	SPYIRKESY
LPIRTTRHF	LPIRTTRHF
LAALGDTAW	LAALGDTAW
WAASAETPL	WAASAETPL
LPYPQPQPF	LPYPQPQPF
FPVRPQVPL	FPVRPQVPL
FASSRMSTY	FASSRMSTY
AIYKNTIAY	AIYKNTIAY
IPMVTQIAM	IPMVTQIAM
YMYRVWSPL	YMYRVWSPL
EAFPYEITE	EAFPYEITE
IPYCNYSKY	IPYCNYSKY
QPYLQLQPF	QPYLQLQPF
LPVYLMTLMK	LPVYLMTLM
TPPGSRDPF	TPPGSRDPF
LPFHRWHTM	LPFHRWHTM
WAGIWGGKL	WAGIWGGKL
SPTEMVDVSM	SPTMVDVSM
VPWQEKTAS	VPWQEKTAS
MPVGGQSSFY	MPVGGQSSF
LPVFTWLAL	LPVFTWLAL
YGSWFGLIY	YGSWFGLIY
IPATLFVWYF	IPATLFVWY
APVSAMVRM	APVSAMVRM
FAGDLYRMY	FAGDLYRMY
TAVDFGNSY	TAVDFGNSY
LAVSGVYPM	LAVSGVYPM
FPSIFSTEV	FPSIFSTEV
YGIPFPGSL	YGIPFPGSL
MALGALGAA	MALGALGAA
TPLPVSLTA	TPLPVSLTA
SQLEMCEKY	SQLEMCEKY
MPGVLSYVV	MPGVLSYVV
MASSVLLWM	MASSVLLWM
YPGNTFVNF	YPGNTFVNF
YAQMWSLMYF	YAQMWSLMY
LPIFSDAAL	LPIFSDAAL
YTMELCGAM	YTMELCGAM
CLLSHTLAY	CLLSHTLAY
MPSEDGAEA	MPSEDGAEA
FPLCLSTTS	FPLCLSTTS
WPVTLACFVL	WPVLACFVL
EPIPYDPKF	EPIPYDPKF
FPHCLAFSYM	FPHCLAFSY
FPSNMMVVT	FPSNMMVVT
TPQPKPGTRM	TPQKPGTRM
MPEKRNVVV	MPEKRNVVV
FVNRYGVAY	FVNRYGVAY
HPALVFDITK	HPALVFDIT
LMNELGVPF	LMNELGVPF
HVPTRGTAM	HVPTRGTAM
MPNMLRIMA	MPNMLRIMA
SPMLYQLLEA	SPMYQLLEA
TVAPPAPVY	TVAPPAPVY
FTWSGDVRY	FTWSGDVRY
MQQSGDEAF	MQQSGDEAF
FPGKTVWFVP	FPGKTVWFV
MPEWANFKF	MPEWANFKF
EAMDTISVF	EAMDTISVF
WPDVFSVSV	WPDVFSVSV
YGIAAHWSY	YGIAAHWSY
VPHVIEEVM	VPHVIEEVM
TPPGTADAF	TPPGTADAF
WPWNAREDV	WPWNAREDV
FPQSNAPIMD	FPQSNAPIM
TPQPMELKY	TPQPMELKY
LMDENTYAM	LMDENTYAM
RPPGCTFPA	RPPGCTFPA
WMQELRAGA	WMQELRAGA
HPLADNKFAL	HPLDNKFAL
SLICGAALY	SLICGAALY
VPWSKILAY	VPWSKILAY
YPSMFTLRHI	YPSMFTLRH
YVIRDLAAM	YVIRDLAAM
LPEIEDEVF	LPEIEDEVF
MPSEDGAEAL	MPSDGAEAL
IAIPAHVRL	IAIPAHVRL
TATPAWDAL	TATPAWDAL
FAADKDSLY	FAADKDSLY
HPRHYATIM	HPRHYATIM
FVAAGAFHM	FVAAGAFHM
VVPLYDTPL	VVPLYDTPL
WQGPSAAAY	WQGPSAAAY
EQNWDWNRY	EQNWDWNRY
LAMTDTTPF	LAMTDTTPF
MAFIAFLRF	MAFIAFLRF
DPIPYDPKF	DPIPYDPKF
LPFYSNVTGF	LPFSNVTGF
VPNYNMIIM	VPNYNMIIM
FPWDILFPA	FPWDILFPA
RVLGRVLPY	RVLGRVLPY
MTIDLDPVIY	MTIDLDPVI
QPYPQSQPQY	QPYQSQPQY
VAGGTSSVY	VAGGTSSVY
KVMALPIPH	KVMALPIPH
LPFYETLPEL	LPFETLPEL
RVYNNTARY	RVYNNTARY
VPSVNEYHM	VPSVNEYHM
RLASYGLYY	RLASYGLYY
YATVAGHEG	YATVAGHEG
VQLQEYDTY	VQLQEYDTY
VPLLAMGCY	VPLLAMGCY
FVADYLARF	FVADYLARF
LPYNWKNFY	LPYNWKNFY
TAAIMLASY	TAAIMLASY
IVDCLTEMYY	IVDCLTEMY
EPVESCPLM	EPVESCPLM
WASGVPAAT	WASGVPAAT
KSWPGVQSF	KSWPGVQSF
FPIKRISAV	FPIKRISAV
FPYSIPATL	FPYSIPATL
LPRRLQLLF	LPRRLQLLF
EFVSANLAM	EFVSANLAM
FPAIFSAEVL	FPAIFSAEV
SPATLLLVL	SPATLLLVL
TFVPIAWAAAY	VPIAWAAAY
IMYDSGAKY	IMYDSGAKY
YPALMPLYA	YPALMPLYA
FPHTELANL	FPHTELANL
YTYGAGSYF	YTYGAGSYF
MPIAAAIGT	MPIAAAIGT
MPARLWLCL	MPARLWLCL
MLMAASRAL	MLMAASRAL
YLGTPNNTY	YLGTPNNTY
RPWMLDKYF	RPWMLDKYF
LIVSGIFPY	LIVSGIFPY
SSMNSDAAY	SSMNSDAAY
TPQDNQLIY	TPQDNQLIY
STFAASGPF	STFAASGPF
LMLADHPEY	LMLADHPEY
MPICMDVRAI	MPIMDVRAI
APFMSDLQF	APFMSDLQF
LANPTADDF	LANPTADDF
WLWVSSSDM	WLWVSSSDM
YPQPQPQY	YP-QPQPQY
MPEWVNFKF	MPEWVNFKF
IAASIILEF	IAASIILEF
HALLATSIF	HALLATSIF
LPHNSVITV	LPHNSVITV
VMLLDIDYF	VMLLDIDYF
IHDHGEQLF	IHDHGEQLF
MPFAGLLII	MPFAGLLII
LPNTLVFQA	LPNTLVFQA
EASTWLDIF	EASTWLDIF
LTFLDCLYY	LTFLDCLYY
MLMTGTLAVF	MLMTGTLAV
IATATWFQY	IATATWFQY
YAMMSLFDM	YAMMSLFDM
ILQEMSETY	ILQEMSETY
IPDELIDVL	IPDELIDVL
DPMVIENGIL	DPMVIENGI
IPFNVVSAM	IPFNVVSAM
FPRDPVSTF	FPRDPVSTF
QPFPSQQPY	QPFPSQQPY
SFWFFHPPY	SFWFFHPPY
LPVCQSSSMR	LPVCQSSSM
MALKLITQF	MALKLITQF
RINEGWPAY	RINEGWPAY
YSQESPQSY	YSQESPQSY
HLIQNPNPF	HLIQNPNPF
LPEFERRTL	LPEFERRTL
YIPFAEDAL	YIPFAEDAL
VPALTIACM	VPALTIACM
IPISGRITA	IPISGRITA
YPDLNFDNTY	YPDNFDNTY
ISDSAQNMM	ISDSAQNMM
IPSTVKTNLY	IPSVKTNLY
QPAFMVASF	QPAFMVASF
HPTTTYKAF	HPTTTYKAF
DVSPLMHLF	DVSPLMHLF
TPQDNQLTY	TPQDNQLTY
TMPELAWAV	TMPELAWAV
WQLGTRWRY	WQLGTRWRY
RVPVSCAVY	RVPVSCAVY
YQNEVTPEY	YQNEVTPEY
FPISHLYIL	FPISHLYIL
KVFDKSLLY	KVFDKSLLY
MPIEPGDIGY	MPIPGDIGY
YPKCDLVEL	YPKCDLVEL
QPFPPQQPY	QPFPPQQPY
YAQMWTLMYF	YAQMWTLMY
FMALVAFLRF	MALVAFLRF
DSMGQGDAY	DSMGQGDAY
FMGRLGPEY	FMGRLGPEY
MPGTFQTTTG	MPGTFQTTT
YAMCLNTFVL	YAMLNTFVL
ISANANFSY	ISANANFSY
MPYNILDRI	MPYNILDRI
LPYVGDTSM	LPYVGDTSM
QQLYTSPSF	QQLYTSPSF
YLHDPLTPY	YLHDPLTPY
CPAEIVDTV	CPAEIVDTV
FGAAVSLLF	FGAAVSLLF
FPWDLLFPA	FPWDLLFPA
VVNDFTVSY	VVNDFTVSY
NPVILSKLM	NPVILSKLM
VATTFVTPM	VATTFVTPM
MALKDFKEF	MALKDFKEF
VPEFAKQYVL	VPEAKQYVL
MPIRYQTTAV	MPIRYQTTA
FPVRPQVPI	FPVRPQVPI
FPFCLAFSY	FPFCLAFSY
YSLAGSSPF	YSLAGSSPF
LVSLGAISF	LVSLGAISF
IQFMHEQGY	IQFMHEQGY
LPWHRLFLL	LPWHRLFLL
LPSETFPNV	LPSETFPNV
VMLDWGIEL	VMLDWGIEL
WPVMQWLTA	WPVMQWLTA
FVRTLFQQM	FVRTLFQQM
MVHQIFGSAY	MVHIFGSAY
MMFDAMGAL	MMFDAMGAL
WPNNCGWKI	WPNNCGWKI
IPTNFSISI	IPTNFSISI
FPGDKTSYW	FPGDKTSYW
LPTNASLSF	LPTNASLSF
FPGCSFSIF	FPGCSFSIF
LPFRNCPRF	LPFRNCPRF
MPASWVMRIM	MPASWVMRI
MFAVGTWMM	MFAVGTWMM
QQLEADYTF	QQLEADYTF
FAAAAARTL	FAAAAARTL
TPEGIIPALF	TPEGIIPAL
MSYAMCLNTF	MSYMCLNTF
VPANSTVLSF	VPASTVLSF
KVLSHGWAY	KVLSHGWAY
FPVRPQVPA	FPVRPQVPA
MASSALLWM	MASSALLWM
KVYWAGIEF	KVYWAGIEF
LPCQLMYAL	LPCQLMYAL
LPLNRAYPL	LPLNRAYPL
REVLNVRYM	REVLNVRYM
