Data	Data aligned
IVAWTRTAT	IVAWTRTAT
APILVVSGI	APILVVSGI
RVLDCRTAF	RVLDCRTAF
DPMVIENGIL	DPMVINGIL
RVIDPRRCL	RVIDPRRCL
RPRWLDARV	RPRWLDARV
YPALMPLYA	YPALMPLYA
SPSVEVKLPD	SPSVEKLPD
RNRDQSNAL	RNRDQSNAL
IPKNFAGPV	IPKNFAGPV
LPFQNIHPI	LPFQNIHPI
SPARLASAI	SPARLASAI
APVSAMVRM	APVSAMVRM
HPAAMPHLLV	HPAAMPHLL
APPKQSRMQF	PPKQSRMQF
WPEIVGAIV	WPEIVGAIV
YPGNTFVNF	YPGNTFVNF
FPNEVGARIL	FPNEVARIL
VPEGQTLDL	VPEGQTLDL
YARAGSSSH	YARAGSSSH
RSRLVSLAL	RSRLVSLAL
NPRGARVIAL	NPRGAVIAL
VPMAGPLVA	VPMAGPLVA
MPSLTLACL	MPSLTLACL
MPMYAIHKV	MPMYAIHKV
APATVCGPKL	APATVGPKL
GPSWGLSLM	GPSWGLSLM
LARVGRERL	LARVGRERL
SPADERAVA	SPADERAVA
MPRSIGGPV	MPRSIGGPV
VPGFHGWAT	VPGFHGWAT
IPYSRVNHA	IPYSRVNHA
GPSLRTTTV	GPSLRTTTV
EPWLRGNQF	EPWLRGNQF
VPNYNLIIM	VPNYNLIIM
LPRPDTRHL	LPRPDTRHL
RPRWLDART	RPRWLDART
LANETTQAL	LANETTQAL
PPLISILMIF	PPLISILMI
YAYEPGSVM	YAYEPGSVM
HPQKVTKFM	HPQKVTKFM
LPGCSFSIF	LPGCSFSIF
HPSDGKCNL	HPSDGKCNL
MPSLTMACM	MPSLTMACM
QPKPGTRMV	QPKPGTRMV
RPYSNVSNL	RPYSNVSNL
KLRETGAPL	KLRETGAPL
GPATNRDYL	GPATNRDYL
DPKKTGGPI	DPKKTGGPI
VVAVGGLAI	VVAVGGLAI
SPRVVGNIL	SPRVVGNIL
FPVTPQVPL	FPVTPQVPL
RVKLSALTL	RVKLSALTL
LPWKTWYPC	LPWKTWYPC
MPAYIRNTL	MPAYIRNTL
APAYSRAL	APAY-SRAL
LPRDASQIT	LPRDASQIT
IPMVTQMAM	IPMVTQMAM
SPATLLLVL	SPATLLLVL
VPSHISSLI	VPSHISSLI
APIKEFKAKI	APIKEKAKI
GPWHLGKLEM	GPWHLKLEM
QPAFMVASF	QPAFMVASF
KPKGKVVDL	KPKGKVVDL
GPWHLGKLEL	GPWHLKLEL
LPTWLGAAI	LPTWLGAAI
IPKAYAGPF	IPKAYAGPF
TPNGNIPTL	TPNGNIPTL
RPTPRGAVM	RPTPRGAVM
GPHETITAL	GPHETITAL
YPKCDLVEL	YPKCDLVEL
RPPGCTFPA	RPPGCTFPA
YMKAPSGAL	YMKAPSGAL
ILRQNMIAL	ILRQNMIAL
EPDGPTPEL	EPDGPTPEL
LPWTSGAST	LPWTSGAST
LPRWPPPQL	LPRWPPPQL
LLRDNRAAL	LLRDNRAAL
FPFKYAAAF	FPFKYAAAF
SPVDRVLTI	SPVDRVLTI
GPVHFRNQV	GPVHFRNQV
LPNGQDALM	LPNGQDALM
RPDTRHLRV	RPDTRHLRV
TPKGAVMDII	TPKGAVMDI
SPGTSGSPIV	SPGTSGSPI
TPLHKYCVNL	TPLHKCVNL
WPALSSIAA	WPALSSIAA
AIAPTRAVL	AIAPTRAVL
MPREDAHFIY	MPREDAHFI
HIRLHQQAL	HIRLHQQAL
RVRRLNWAA	RVRRLNWAA
KLRSNALSL	KLRSNALSL
RSMPGTRRVM	RSMPGRRVM
KPGTSGSPII	KPGTSGSPI
MPKAGLLII	MPKAGLLII
SPYRTLMSCPI	SPYRTLMSC
RPGYFTQTA	RPGYFTQTA
LPFHRWHTMV	LPFHRWHTM
FPRSAERAG	FPRSAERAG
MPEKRNVVV	MPEKRNVVV
YHRPLTGYM	YHRPLTGYM
LPRRSGAAGA	LPRRSGAAG
RERLSRMAI	RERLSRMAI
GPMKLVMAF	GPMKLVMAF
RPLLARMPE	RPLLARMPE
RPTPKGAVMD	RPTPKGAVM
FPHCLAFSYM	FPHCLAFSY
APRQPGLMA	APRQPGLMA
RPTFAAGLLL	RPTFAGLLL
YPYQLMLSL	YPYQLMLSL
SPMLYQLLEA	SPMLYLLEA
LPQTRWQAV	LPQTRWQAV
TPRMCTREEF	TPRMCREEF
SPMEVMLRA	SPMEVMLRA
CPRIFSHSF	CPRIFSHSF
VMTEGRHAV	VMTEGRHAV
TPRGTVMDI	TPRGTVMDI
IPIPSSWAI	IPIPSSWAI
LVRDITESL	LVRDITESL
WPDVFSVSV	WPDVFSVSV
RAMKALSSI	RAMKALSSI
RAAQRRTAA	RAAQRRTAA
RPQHVKKSA	RPQHVKKSA
IPMSTYGWNL	IPMSTGWNL
LAHRTRNAL	LAHRTRNAL
CPNCYDSVM	CPNCYDSVM
RPRLCTREEF	RPRLCREEF
AAVKAGAAL	AAVKAGAAL
IPAHPLRML	IPAHPLRML
VPYNMRVIHF	VPYNMRVIH
FPWDILFPA	FPWDILFPA
LPQFATAAT	LPQFATAAT
KSAQVPLPL	KSAQVPLPL
IPFSEGKAL	IPFSEGKAL
RVMAPRALL	RVMAPRALL
IPSTVKTNL	IPSTVKTNL
EPATQTFDM	EPATQTFDM
YPIVKGFAV	YPIVKGFAV
KPKPAVRFAI	KPKPARFAI
MIRAQAGSL	MIRAQAGSL
TPRAKRGTA	TPRAKRGTA
TPPVDRMAV	TPPVDRMAV
KPEGKVIDL	KPEGKVIDL
RPAVGGKTV	RPAVGGKTV
MPLKVQVCI	MPLKVQVCI
FPPGTSLTI	FPPGTSLTI
HSRRSRRSL	HSRRSRRSL
NPWMEDKTPV	NPWMEKTPV
KPIDDRFAT	KPIDDRFAT
NPDNTIAVI	NPDNTIAVI
LPFDKPTIM	LPFDKPTIM
LPSIPGTSI	LPSIPGTSI
RVYSDHQAL	RVYSDHQAL
FPRFKFVWV	FPRFKFVWV
LPPPARPPI	LPPPARPPI
VPNYNMIIM	VPNYNMIIM
LPFLKSLAI	LPFLKSLAI
MPAHGPAKNM	MPAHGAKNM
HVPTRGTAM	HVPTRGTAM
CPFLFLTVL	CPFLFLTVL
FPGLYGASI	FPGLYGASI
GGRAHRMAL	GGRAHRMAL
FPIGKLTLL	FPIGKLTLL
FPYEGGKVF	FPYEGGKVF
EIRHRSGIQ	EIRHRSGIQ
IPKRNRSIL	IPKRNRSIL
SPMETTAEF	SPMETTAEF
TPRGAVMDII	TPRGAVMDI
SPGDLQTLAL	SPGDLTLAL
RPRFDDAYNI	RPRFDAYNI
RPRGDNFAV	RPRGDNFAV
RPSTRNFFEL	RPSTRFFEL
FPVRPQVPF	FPVRPQVPF
IPLTTAAKL	IPLTTAAKL
RPRHQGVMV	RPRHQGVMV
HPGFTIMAAI	HPGFTMAAI
LPMTVAAMGV	LPMTVAMGV
VPAMFTAAL	VPAMFTAAL
KPGTSGSPI	KPGTSGSPI
RPASAWTLYA	RPASATLYA
NPRMFLAMI	NPRMFLAMI
RSLCHATAM	RSLCHATAM
FPGCSFSIF	FPGCSFSIF
TPVWHVTSA	TPVWHVTSA
IPELKHGLL	IPELKHGLL
YPMSIPATL	YPMSIPATL
FPTSRTTWSI	FPTSRTWSI
FPYSIPATL	FPYSIPATL
APEEKYLSM	APEEKYLSM
SPMVIATTDM	SPMVITTDM
SPIVPSFDM	SPIVPSFDM
LPTKLRPSA	LPTKLRPSA
GPFEASWAI	GPFEASWAI
QPEWFRNVL	QPEWFRNVL
LPFDRTITVM	LPFDRITVM
SPRRARRAL	SPRRARRAL
RPMREVRFL	RPMREVRFL
TPSGKRLQI	TPSGKRLQI
MPYNILDRI	MPYNILDRI
RPALVFDIT	RPALVFDIT
APNAKEEIL	APNAKEEIL
FPREGVFVF	FPREGVFVF
TPKFTRMVV	TPKFTRMVV
NPTTLTASL	NPTTLTASL
FPPTSFGPL	FPPTSFGPL
APFANTYSAL	APFANYSAL
MTQKARDAL	MTQKARDAL
VPTNDHIPVV	VPTNDHIPV
AAKKKGASL	AAKKKGASL
HPYKIPATV	HPYKIPATV
DPMVIENGI	DPMVIENGI
LPDALLFTL	LPDALLFTL
FPAIFSAEV	FPAIFSAEV
LPYPQPQL	LPYP-QPQL
LPFDRTTVM	LPFDRTTVM
MPDCGMSVL	MPDCGMSVL
SVAMCRTPF	SVAMCRTPF
APDPSRLAF	APDPSRLAF
MPVMKRYSA	MPVMKRYSA
QMRDVLGTF	QMRDVLGTF
SPLAASKECAV	SPLAASKEC
IPIGTYGQM	IPIGTYGQM
IPMVTQLAM	IPMVTQLAM
AVRLVVGPL	AVRLVVGPL
RPMPGTRKV	RPMPGTRKV
VPLQWIASA	VPLQWIASA
FPNEVGARI	FPNEVGARI
QPRAPIRPI	QPRAPIRPI
FPYIMGSVEL	FPYIMSVEL
KPTGSASSL	KPTGSASSL
RPNHTIKGSF	RPNHTKGSF
HPGFTLMAAI	HPGFTMAAI
MPYNILDRII	MPYNIDRII
FPRGQGVPI	FPRGQGVPI
APSPYNSRF	APSPYNSRF
GPRLGVRAT	GPRLGVRAT
TPLGAINSSL	TPLGANSSL
TPQSNRPVM	TPQSNRPVM
GVWEEVGCAKG	GVWEEVGCA
TPEARNSTFL	TPEARNSTF
LPRYNIATSV	LPRYNATSV
ATYQRTRAL	ATYQRTRAL
IVKQGRDAL	IVKQGRDAL
CPQKKKSQA	CPQKKKSQA
SPGYVLGIFL	SPGYVLGIF
YPSLMSRVV	YPSLMSRVV
APFARLLNL	APFARLLNL
MPLKKQILF	MPLKKQILF
FPAQPGLTSA	FPAQPLTSA
IPRRIRQGL	IPRRIRQGL
TPTGTVMDII	TPTGTVMDI
LPADPASVL	LPADPASVL
LPFDRQTVM	LPFDRQTVM
IPTAMAFHL	IPTAMAFHL
ILRNPGFAL	ILRNPGFAL
LPPFTQHLL	LPPFTQHLL
NPSILPSLI	NPSILPSLI
SPRTLRRAF	SPRTLRRAF
NPYTSRRSV	NPYTSRRSV
KPKFCLIDGM	KPKFCLIDG
RPASGYSTL	RPASGYSTL
KPFNNILNL	KPFNNILNL
APGSPTNLEF	APGSPNLEF
APRTLVYLL	APRTLVYLL
RLRDAVAQL	RLRDAVAQL
IPRQWHPFA	IPRQWHPFA
FPVRPQVPL	FPVRPQVPL
RAWDPQPAM	RAWDPQPAM
RPRGHREFC	RPRGHREFC
RPNRQLGSM	RPNRQLGSM
SPYNSRFESV	SPYNSFESV
RSRWSRKMLM	RSRWSRKML
VPASRYLTDM	VPASRLTDM
SPKFTTSLSL	SPKFTSLSL
RPAKNGTVM	RPAKNGTVM
APATPAVVL	APATPAVVL
APFESEGVL	APFESEGVL
SPSKLASAI	SPSKLASAI
LPAALAFHL	LPAALAFHL
IPAFYTPTA	IPAFYTPTA
CPNSYDSIM	CPNSYDSIM
YMREVGAAL	YMREVGAAL
GPAEARKVC	GPAEARKVC
FLRKNQRAL	FLRKNQRAL
GPALSINEL	GPALSINEL
IHYAGWVSL	IHYAGWVSL
GPATAQMAL	GPATAQMAL
NPLFHGGEPI	NPLFHGEPI
LPAIVREAI	LPAIVREAI
FPAGLTYSQL	FPAGLYSQL
NPALRMKWM	NPALRMKWM
KPASRELSV	KPASRELSV
RPYGKFRAM	RPYGKFRAM
APAWSRRTL	APAWSRRTL
TPHSGEEHAV	TPHSGEHAV
VPHISRQRL	VPHISRQRL
RLRMDKLQL	RLRMDKLQL
KPIMSMGDII	KPIMSMGDI
RIRFVQNAL	RIRFVQNAL
KPRWLDARI	KPRWLDARI
RPNPDFNTF	RPNPDFNTF
HPNIEEVAL	HPNIEEVAL
VVRPPFNML	VVRPPFNML
LPSIVREAL	LPSIVREAL
EPFSRRHPL	EPFSRRHPL
LPIRYQTPA	LPIRYQTPA
RPRWLDARVY	RPRWLDARV
RPAPGGKAY	RPAPGGKAY
NPIINTHSF	NPIINTHSF
KPRICTREEF	KPRICREEF
RPPIFIRRL	RPPIFIRRL
HPASAWTLYA	HPASATLYA
FPINLNSSQL	FPINLSSQL
KPINLSNSV	KPINLSNSV
LPRRSLKAF	LPRRSLKAF
LPFQNVHPV	LPFQNVHPV
TPFGQQRVF	TPFGQQRVF
QPFLQPQL	QPFL-QPQL
KPLIKWDLL	KPLIKWDLL
MPVDHPLSL	MPVDHPLSL
QPHWIAASI	QPHWIAASI
LPFQNIHPITI	LPFQNIHPI
GPLRMVLAF	GPLRMVLAF
NPIQLSSYSL	NPIQLSYSL
SPVMGVIGF	SPVMGVIGF
RVSSDQSAL	RVSSDQSAL
APSMTMRCI	APSMTMRCI
QPHQLWTTL	QPHQLWTTL
RPTFYRQGL	RPTFYRQGL
VPRVHNQPQ	VPRVHNQPQ
QPEWFRNIL	QPEWFRNIL
TPRIEGGTF	TPRIEGGTF
IVRQGIRQL	IVRQGIRQL
SPGRKNGSF	SPGRKNGSF
VPMVTQMAM	VPMVTQMAM
EPHWIAASI	EPHWIAASI
LPMIIGEPI	LPMIIGEPI
HPLSHFVNL	HPLSHFVNL
LPFDRATVM	LPFDRATVM
YPSMFTLRHI	YPSMFLRHI
YLKKGRLSL	YLKKGRLSL
NPTKYIRWKL	NPTKYRWKL
TPARVTGGVF	TPARVGGVF
LPFDRSTVM	LPFDRSTVM
APTRVVAAEM	APTRVAAEM
MPSEDGAEA	MPSEDGAEA
SPGKFWNTTI	SPGKFNTTI
RPRLCTREE	RPRLCTREE
SPIINREGKV	SPIINEGKV
CPTQGEAIL	CPTQGEAIL
LPFDKTTVM	LPFDKTTVM
APALATGSF	APALATGSF
VPLAHSSSA	VPLAHSSSA
LVMAPRTVL	LVMAPRTVL
APGFNTTPA	APGFNTTPA
VMAASGAPF	VMAASGAPF
YPYSSSARF	YPYSSSARF
LPVCAPSSA	LPVCAPSSA
YPAEITLTW	YPAEITLTW
KPESRPFDL	KPESRPFDL
DPRRCMKPV	DPRRCMKPV
APSYGMRCVG	APSYGMRCV
NPTSETMYL	NPTSETMYL
SPNLAWPLIV	SPNLAWPLI
IPTNFSISI	IPTNFSISI
FPSIFSTEV	FPSIFSTEV
RLRDLNQAV	RLRDLNQAV
GPHVPESAF	GPHVPESAF
RAVEPGTVL	RAVEPGTVL
GPRTAALGLL	GPRTAALGL
APTRVVASEM	APTRVASEM
FPVRPQVPV	FPVRPQVPV
VPFVVFLVA	VPFVVFLVA
VPNYNLIVM	VPNYNLIVM
GPRQWRWPL	GPRQWRWPL
ALMEVTHVL	ALMEVTHVL
VPMAGPLVAG	VPMAGPLVA
LPFDRTTIM	LPFDRTTIM
RVRALAWLL	RVRALAWLL
KPDHDGNTPL	KPDHDNTPL
NPKASTISW	NPKASTISW
IPTAAGKNL	IPTAAGKNL
RGRAATMAL	RGRAATMAL
RPRVTKQYIV	RPRVTKQYI
LPTTITVPV	LPTTITVPV
MPFAGLLII	MPFAGLLII
LAMATTLQL	LAMATTLQL
YPLSIPATL	YPLSIPATL
VPEFAKQYV	VPEFAKQYV
LARQHIAAL	LARQHIAAL
IPIPSSWAF	IPIPSSWAF
FPLCANGQVF	FPLCAGQVF
RIYRKGNPL	RIYRKGNPL
FPAPRAETL	FPAPRAETL
SPKRLATAIA	SPKRLATAI
APHHKILAKA	APHHKLAKA
FPVRPQVPI	FPVRPQVPI
RVKQHMASM	RVKQHMASM
FPVRPQVPA	FPVRPQVPA
IPFYGKAI	IPFY-GKAI
LPQYFTFDL	LPQYFTFDL
SPQECNNMHL	SPQECNMHL
LPAQLTATA	LPAQLTATA
RPTPKGAVM	RPTPKGAVM
RNQPAATAL	RNQPAATAL
FPVRPQVPM	FPVRPQVPM
KPAMSTYSDI	KPAMSYSDI
RPMTYKAAL	RPMTYKAAL
HPLARTAKV	HPLARTAKV
TPGRYRTAV	TPGRYRTAV
MPILTLTRAL	MPILTTRAL
IPISGRITA	IPISGRITA
YPNSSDLDM	YPNSSDLDM
RVIDSRKSV	RVIDSRKSV
CPMCCSKIL	CPMCCSKIL
RMMETWHPL	RMMETWHPL
VPAQNAIST	VPAQNAIST
GPMPVTVASA	GPMPVVASA
MAAAAFPAL	MAAAAFPAL
SPARLASAIL	SPARLASAI
RVRLSMLTV	RVRLSMLTV
IPRRNVATL	IPRRNVATL
IPYLRNYMVI	IPYLRNYMV
VPTSRTTWSI	VPTSRTWSI
RAPKVRLSL	RAPKVRLSL
WPWNAREDV	WPWNAREDV
KPTFKHASV	KPTFKHASV
APFMSDLQF	APFMSDLQF
FPYSIPATLL	FPYSIPATL
KPVGWAMSF	KPVGWAMSF
KPRLCTREE	KPRLCTREE
MPREDAHFI	MPREDAHFI
AVRQKSRWI	AVRQKSRWI
FPCSICLSGL	FPCSILSGL
WAQSGRRAL	WAQSGRRAL
RPINEKEENM	RPINEEENM
VPDIKLDAVL	VPDIKDAVL
LPYPQPQPF	LPYPQPQPF
KPRLCTREEF	KPRLCREEF
HPGFTLMAA	HPGFTLMAA
RPPRRGDKF	RPPRRGDKF
RPVGISSMV	RPVGISSMV
KPTESACSSL	KPTESCSSL
LPRERFRKT	LPRERFRKT
RPRQIAMSL	RPRQIAMSL
FPSSSYRRPV	FPSSSRRPV
LVRGNSPVF	LVRGNSPVF
APKQVAGTGV	APKQVGTGV
MPNMLRIMA	MPNMLRIMA
APSYRNFSF	APSYRNFSF
APRELLQYI	APRELLQYI
TPYAGEPAPF	TPYAGPAPF
RPTPTGTVMD	RPTPTGTVM
SPIVNREGKI	SPIVNEGKI
IPFNVVSAM	IPFNVVSAM
RPQLGVGDV	RPQLGVGDV
RPPLNRNYV	RPPLNRNYV
TPEGIIPSM	TPEGIIPSM
VPLQLPPL	VPLQ-LPPL
AVSKNRRQL	AVSKNRRQL
HPGFTILAL	HPGFTILAL
FPHTELANL	FPHTELANL
LPANLTLMM	LPANLTLMM
KLAQVRRAM	KLAQVRRAM
RAAPLMQSL	RAAPLMQSL
SPSKRNQTF	SPSKRNQTF
RAYRNALSM	RAYRNALSM
KVHLTPAQL	KVHLTPAQL
FPGDKTSYWV	FPGDKSYWV
LPEFERRTL	LPEFERRTL
RPNITSTAL	RPNITSTAL
SPRLKAICI	SPRLKAICI
GPGHKARVL	GPGHKARVL
TPKKNCIAI	TPKKNCIAI
GPIRFVLAL	GPIRFVLAL
NPLTLTAAV	NPLTLTAAV
TPTWNRKEL	TPTWNRKEL
PPEVERAVL	PPEVERAVL
ARWLASTPL	ARWLASTPL
HPRHYATVM	HPRHYATVM
APAFVVIADL	APAFVIADL
MPICMDVRAI	MPICMVRAI
IPKSLAGPIS	IPKSLAGPI
RRRPVTRPL	RRRPVTRPL
FLKDVMESM	FLKDVMESM
MPIRYQTTAV	MPIRYTTAV
MPTYKHLIMF	MPTYKHLIM
LPFDRPTVM	LPFDRPTVM
HPRHYATIM	HPRHYATIM
IPSYKKLIM	IPSYKKLIM
RVMVMVGATM	RVMVMGATM
LPVNVAFEL	LPVNVAFEL
VIARTHTAL	VIARTHTAL
LPTNASLSF	LPTNASLSF
TPAQLSMLL	TPAQLSMLL
KPLKDVERL	KPLKDVERL
NPITLTAAL	NPITLTAAL
YLRQRQVAL	YLRQRQVAL
SPRWYFYYL	SPRWYFYYL
IPKQKVAGPL	IPKQKAGPL
TPEARNSTF	TPEARNSTF
FPASFFIKL	FPASFFIKL
LPRVVGGKTV	LPRVVGKTV
SPRPEMQEF	SPRPEMQEF
VPWSKILAY	VPWSKILAY
RPEIDVLPF	RPEIDVLPF
SPGYVLGVF	SPGYVLGVF
MPASWVMRI	MPASWVMRI
TPMLRHSI	TPML-RHSI
APHHVVAVI	APHHVVAVI
MPEKRNVVVV	MPEKRNVVV
GPLVAGGLL	GPLVAGGLL
KPDGSDSMDV	KPDGSSMDV
YPEYNRAVKF	YPEYNAVKF
FPVRPQVPC	FPVRPQVPC
SPKGVEESSI	SPKGVESSI
APASLTKIM	APASLTKIM
YPLAIPVTM	YPLAIPVTM
YSLAGSSPF	YSLAGSSPF
NPAWRKAVF	NPAWRKAVF
KPGPAKFSL	KPGPAKFSL
FPQVGGLTSI	FPQVGLTSI
APITTTTTV	APITTTTTV
HPVHAGPIA	HPVHAGPIA
RPAKSGTVMD	RPAKSGTVM
LPFDKTTIM	LPFDKTTIM
IPLSILLTL	IPLSILLTL
SPCKIPFEIM	SPCKIPFEI
RPMSLRSTII	RPMSLRSTI
GLRWHVRAF	GLRWHVRAF
GPQSNQRSA	GPQSNQRSA
MPLETQLAI	MPLETQLAI
VPRKPLLSYI	VPRKPLLSY
YLAGAGLAF	YLAGAGLAF
LPQIGGEAI	LPQIGGEAI
RARLVALAV	RARLVALAV
MPASWVMRIM	MPASWMRIM
IPAEMLASI	IPAEMLASI
LPIFSEFVL	LPIFSEFVL
SPKRLATAI	SPKRLATAI
SPLGERLEV	SPLGERLEV
SPMGPLAVSF	SPMGPAVSF
SPQANNLYL	SPQANNLYL
GPGEVSAAM	GPGEVSAAM
FAAAAARTL	FAAAAARTL
IAQLNRPAM	IAQLNRPAM
KPLLAPHHVV	KPLLAHHVV
IPKIYGGPI	IPKIYGGPI
GAAGARGAL	GAAGARGAL
VPHVIEEVM	VPHVIEEVM
FPISHLYIL	FPISHLYIL
NPRLCTREE	NPRLCTREE
RPASAWTLY	RPASAWTLY
LPHIIDEVM	LPHIIDEVM
HPAAMPHLL	HPAAMPHLL
SPAAAQKAT	SPAAAQKAT
CPTLKKGFL	CPTLKKGFL
FPQHVITKDV	FPQHVTKDV
LPSLPGHTA	LPSLPGHTA
MLREGNQAF	MLREGNQAF
LPVCQSSSM	LPVCQSSSM
WPLLPHVIF	WPLLPHVIF
YLRQRQAAL	YLRQRQAAL
LPWTSGATT	LPWTSGATT
GPMVAGGLLL	GPMVAGGLL
RFASALTAL	RFASALTAL
VPMEKLKAL	VPMEKLKAL
IPQFRTLVI	IPQFRTLVI
HPGFTIMAA	HPGFTIMAA
VPISSVASL	VPISSVASL
IPLCRTSCL	IPLCRTSCL
QPQWIAASI	QPQWIAASI
LPFSASIVF	LPFSASIVF
LPYSQPQPF	LPYSQPQPF
LPVYLMTLM	LPVYLMTLM
RVRQLDESI	RVRQLDESI
TPLVQPVGAL	TPLVQVGAL
NAFGWENAY	NAFGWENAY
AVAVARVAA	AVAVARVAA
MPVTVASAAQ	MPVTVASAA
RVAPPAVAL	RVAPPAVAL
QPHWIAASII	QPHWIAASI
LVMKDGRVL	LVMKDGRVL
FPLKLRGTAV	FPLKLGTAV
RPIVSTQLL	RPIVSTQLL
TPNLAERVL	TPNLAERVL
HPGFTVIAL	HPGFTVIAL
LPFGRTTVM	LPFGRTTVM
IPYLGKREDL	IPYLGREDL
FPVAMLSCL	FPVAMLSCL
IVRTNRNEL	IVRTNRNEL
MVRRGVRSL	MVRRGVRSL
ITSKSRQVL	ITSKSRQVL
APVLRDIDL	APVLRDIDL
QPAGGKAEF	QPAGGKAEF
YPAVINSNI	YPAVINSNI
YLRKHIRAL	YLRKHIRAL
FLRDNRAVL	FLRDNRAVL
IPVDLVKSSF	IPVDLKSSF
RPCFWVELI	RPCFWVELI
RPWVSFDQNL	RPWVSDQNL
GVRQFSGWM	GVRQFSGWM
FPNITNLCPF	FPNITLCPF
SPVLRLFFL	SPVLRLFFL
LPSWLLAPV	LPSWLLAPV
KPNTWCLRCL	KPNTWLRCL
YPITGVKSL	YPITGVKSL
YMYRVWSPL	YMYRVWSPL
NPKASTISWM	NPKASISWM
RPMSASRPA	RPMSASRPA
KPSGSASSMV	KPSGSASSM
APYFATVRL	APYFATVRL
LPFHRWHTM	LPFHRWHTM
LPFERATV	LPFE-RATV
TPIFSDLLKY	TPIFSLLKY
NPANKEESI	NPANKEESI
NPNMIDKTPV	NPNMIKTPV
GPASLPTAL	GPASLPTAL
KPKVASEAF	KPKVASEAF
LPFHNVHPL	LPFHNVHPL
DPSRGRLGL	DPSRGRLGL
NPGFALLAGF	NPGFALLAG
FPQAAPHGVV	FPQAAHGVV
LPWHRLFLL	LPWHRLFLL
QPYRVVVLSF	QPYRVVLSF
APIEHIASM	APIEHIASM
DPRRCLKPV	DPRRCLKPV
KPEFCIKVL	KPEFCIKVL
LPFYETLPEL	LPFYELPEL
RPADKIQML	RPADKIQML
LLRRRPYPL	LLRRRPYPL
FPLTQRDVL	FPLTQRDVL
FPICSTYKFL	FPICSTYKF
WPVMQWLTA	WPVMQWLTA
QQSEARRML	QQSEARRML
RPVSPGKDI	RPVSPGKDI
RPRWADARV	RPRWADARV
TPFAEYTNSV	TPFAETNSV
HPIMYYTKF	HPIMYYTKF
LPIFSDAAL	LPIFSDAAL
FPVRPQVPH	FPVRPQVPH
TPRDLGACI	TPRDLGACI
VAAKGAPAL	VAAKGAPAL
YPLASLRSLF	YPLASLRSL
VPISHLYIL	VPISHLYIL
SPAATQKAA	SPAATQKAA
SPSKLASAIQ	SPSKLASAI
FPMAVKLFI	FPMAVKLFI
FPQSNAPIM	FPQSNAPIM
MPAIFFSIV	MPAIFFSIV
LPLMMLSPL	LPLMMLSPL
LPSIPVHPI	LPSIPVHPI
MPYVFTLLF	MPYVFTLLF
FPRVSTPLA	FPRVSTPLA
GPRGALSLL	GPRGALSLL
LPLAKPMVI	LPLAKPMVI
TVAWRTATL	TVAWRTATL
SPVIVNGAM	SPVIVNGAM
YPASLHKFF	YPASLHKFF
RPTPKKMNIV	RPTPKKMNI
APNPNRFVI	APNPNRFVI
SPPETQKAEL	SPPETKAEL
AVRTDGSNI	AVRTDGSNI
MQRSGMLSL	MQRSGMLSL
RPLLIEGTA	RPLLIEGTA
RPTPRGTVM	RPTPRGTVM
TPRSPSVEV	TPRSPSVEV
SVFPFDGTR	SVFPFDGTR
LPLNRAYPL	LPLNRAYPL
APAAPTPAA	APAAPTPAA
YPKIYKTYF	YPKIYKTYF
LPPERRQPF	LPPERRQPF
YVKQNTLKL	YVKQNTLKL
RPASAGAML	RPASAGAML
IPKSLAGPI	IPKSLAGPI
HTSSGRTSL	HTSSGRTSL
RPRGEVRFL	RPRGEVRFL
LPACVYGLAV	LPACVGLAV
LAAPCRNAL	LAAPCRNAL
VPAPAGPIV	VPAPAGPIV
APKRPPSAF	APKRPPSAF
LVSLLGSAL	LVSLLGSAL
SPRTLNAWV	SPRTLNAWV
HPRARSMSS	HPRARSMSS
GPDNGAVAVL	GPDNGVAVL
LPDYGELTL	LPDYGELTL
SPYYIRKESY	SPYYIRKES
CPKVSFEPI	CPKVSFEPI
FPICSVFKFL	FPICSVFKF
IVAQGIAAL	IVAQGIAAL
FPKAFINIV	FPKAFINIV
RPAKNGTVMD	RPAKNGTVM
CPIGENSPL	CPIGENSPL
SPPIPMSRLF	SPPIPMSRL
RPGPVKFSL	RPGPVKFSL
FPRDPVSTF	FPRDPVSTF
GPMVAGGLL	GPMVAGGLL
AAAQGQAPL	AAAQGQAPL
SASVQRADTSL	SVQRADTSL
RVATENIAV	RVATENIAV
TPIAYRNVL	TPIAYRNVL
IPRTMLPLSL	IPRTMPLSL
TPRGAVMDI	TPRGAVMDI
YPKLKNSYV	YPKLKNSYV
APRTVALTA	APRTVALTA
FPLCLSTTSQ	FPLCLSTTS
APLLSAGIF	APLLSAGIF
VPRPCQKSL	VPRPCQKSL
TPTWNRKELL	TPTWNRKEL
YPDRLRLSV	YPDRLRLSV
QPYLQLQPF	QPYLQLQPF
WAASAETPL	WAASAETPL
FPVRPQVPY	FPVRPQVPY
LPAGSRIWL	LPAGSRIWL
SARTNCLAV	SARTNCLAV
LPTRCRLEI	LPTRCRLEI
YPPPRYITV	YPPPRYITV
CPKYVRSAKL	CPKYVSAKL
MTQKARNAL	MTQKARNAL
VLRQAALSL	VLRQAALSL
NPRLCTREEF	NPRLCREEF
ALRSRWRAL	ALRSRWRAL
VPMSTYGWNI	VPMSTGWNI
SPGMMMGMF	SPGMMMGMF
LGPRAAAAGAL	GPRAAAGAL
VPIAWAAA	VPIA-WAAA
IPSIQSRGL	IPSIQSRGL
RPAADGKTV	RPAADGKTV
HPALVFDIT	HPALVFDIT
VPRYAFAM	VPRY-AFAM
KPRSQMETDF	KPRSQETDF
KPHETAIKEV	KPHETIKEV
RPRWGAAAS	RPRWGAAAS
SPRIKFLDL	SPRIKFLDL
SPVSRSHSF	SPVSRSHSF
HPLADNKFAL	HPLADKFAL
RPKWLDARV	RPKWLDARV
RPIFEWIEA	RPIFEWIEA
RPWMLDKYF	RPWMLDKYF
KLRHGQRSL	KLRHGQRSL
HPLHHPLSI	HPLHHPLSI
RSNAALGAIF	RSNAALGAI
GPLKLFMAL	GPLKLFMAL
GPRTRGYAI	GPRTRGYAI
RLSQSGHML	RLSQSGHML
SPGYVLGVFL	SPGYVLGVF
SPMEHSKRI	SPMEHSKRI
RPTFAAGLL	RPTFAAGLL
RLRRDQRSL	RLRRDQRSL
TPRGTVMDII	TPRGTVMDI
IPLGGNGAM	IPLGGNGAM
LPMIIGEPII	LPMIIGEPI
RTRAGRHAF	RTRAGRHAF
LPYGRTNL	LPYG-RTNL
FPVRPQVPT	FPVRPQVPT
QPRAPIRPIPT	QPRAPIRPI
IPEQSRCQAI	IPEQSCQAI
RLRQEVYLSL	RLRQEYLSL
FPKAGLLII	FPKAGLLII
LPLERAIAV	LPLERAIAV
CPLERFAEL	CPLERFAEL
YPKFHRSAM	YPKFHRSAM
APQLVSTAA	APQLVSTAA
QPMEHKYSW	QPMEHKYSW
IPIHYCAPA	IPIHYCAPA
TPNNLNKIQL	TPNNLKIQL
IPKGIMMNV	IPKGIMMNV
RPRIRLSAP	RPRIRLSAP
RPDTRYVLM	RPDTRYVLM
RVLTARKTV	RVLTARKTV
APSESEGVL	APSESEGVL
SPPPVGKAEL	SPPPVKAEL
GPMPVTAASA	GPMPVAASA
IPFNVVTAM	IPFNVVTAM
RPEAAAGQL	RPEAAAGQL
RVRSLAKSL	RVRSLAKSL
GPMKLVMAFI	GPMKLVMAF
LPCQLMYAL	LPCQLMYAL
LPFDRITVM	LPFDRITVM
AARPATSTL	AARPATSTL
KPKHLYVSL	KPKHLYVSL
LPLEFWQAW	LPLEFWQAW
CPTQGEATL	CPTQGEATL
RPSVNGGRI	RPSVNGGRI
GPMMCPFLF	GPMMCPFLF
NPTAIFLTTL	NPTAILTTL
IPLQASLPF	IPLQASLPF
APHGVVFLHV	APHGVFLHV
TPQAPTSEI	TPQAPTSEI
TPNLAKRVL	TPNLAKRVL
LPIRYQTPAV	LPIRYQTPA
VPRLGDKTF	VPRLGDKTF
SPLFLIVAA	SPLFLIVAA
MPVTVASAA	MPVTVASAA
LPKRGVRVRV	LPKRGRVRV
ESMMGSTAM	ESMMGSTAM
TPNQPSAEF	TPNQPSAEF
SPAIFQSSM	SPAIFQSSM
SPYNSQNAVA	SPYNSQNAV
IPMTLTASPL	IPMTLASPL
FAAPHRGVA	FAAPHRGVA
IPMVTQIAM	IPMVTQIAM
YPMSIPATLF	YPMSIPATL
FPVRPQVPW	FPVRPQVPW
SPGTSGSPII	SPGTSGSPI
SPAATQKAAL	SPAATKAAL
TPRRGTGTTG	TPRRGTGTT
NPNMTDKTPV	NPNMTKTPV
LPHNSVITV	LPHNSVITV
TPVMSRFAA	TPVMSRFAA
LPQIGGEAIF	LPQIGGEAI
FPVRPQVPK	FPVRPQVPK
KPKLKVATL	KPKLKVATL
GPRWPRRMP	GPRWPRRMP
KPSGSASSM	KPSGSASSM
SPGTSGSPI	SPGTSGSPI
TPQDNQLAYV	TPQDNQLAY
APSTGSASSM	APSTGASSM
QPQWIAASII	QPQWIAASI
MPWLTTGPM	MPWLTTGPM
MPTDMLKLF	MPTDMLKLF
LPIDKCSRI	LPIDKCSRI
LQRKHGGSL	LQRKHGGSL
RPGGRGALL	RPGGRGALL
RLSSLSLAL	RLSSLSLAL
SPKRLSAAI	SPKRLSAAI
RPSGPGPEL	RPSGPGPEL
APNVISSKI	APNVISSKI
ALRQARAAF	ALRQARAAF
ATAQNRRAL	ATAQNRRAL
RPTPKGTVMD	RPTPKGTVM
IPMATYGWNL	IPMATGWNL
FPANINDKQI	FPANIDKQI
KPYTAGNKV	KPYTAGNKV
LPVFTWLAL	LPVFTWLAL
SPKRLSAAIG	SPKRLSAAI
TPQASTTEAI	TPQASTEAI
IPKSYAGPF	IPKSYAGPF
RVYAELAAL	RVYAELAAL
LPTNAVVKM	LPTNAVVKM
APYPNVVEM	APYPNVVEM
SPLQLRFRM	SPLQLRFRM
SPVRVPNYNM	SPVRVNYNM
APKEFRGAL	APKEFRGAL
LPTSIVVPI	LPTSIVVPI
IPEGRVIDL	IPEGRVIDL
YLREHIRAM	YLREHIRAM
RPTPTGTVM	RPTPTGTVM
TPVSMTYLY	TPVSMTYLY
FPVRPQVPD	FPVRPQVPD
MPYETLVGL	MPYETLVGL
KPVDTSNSF	KPVDTSNSF
KVAQAAAAM	KVAQAAAAM
LPAGSPVAV	LPAGSPVAV
RPALVFDITK	RPALVFDIT
RPMFAVGLLF	RPMFAVGLL
LPVFATIGL	LPVFATIGL
SPLFLIVAAL	SPLFLVAAL
IPMTGPLVA	IPMTGPLVA
CPASKKESVI	CPASKKESV
LPTLFGRGV	LPTLFGRGV
RPGYHTQTA	RPGYHTQTA
RPKQRRPQGL	RPKQRPQGL
AATIRVLAL	AATIRVLAL
IPYLRNYMV	IPYLRNYMV
SPLMVAYML	SPLMVAYML
CPTQGEAVL	CPTQGEAVL
APIMFSNKM	APIMFSNKM
FVRQCFNPM	FVRQCFNPM
VPMPNIIMV	VPMPNIIMV
PPYCTIAPV	PPYCTIAPV
SPTEMVDVSM	SPTEMDVSM
SPAHLINKLL	SPAHLINKL
FIRDCSVAL	FIRDCSVAL
AARHKHQVM	AARHKHQVM
SPPIPMSRL	SPPIPMSRL
IPGDILSII	IPGDILSII
LPAIIRPSF	LPAIIRPSF
SPETQQMII	SPETQQMII
LPQPPICTI	LPQPPICTI
LPFDRTTVI	LPFDRTTVI
TPAVCGPVI	TPAVCGPVI
SPGEIKPKF	SPGEIKPKF
TPNYMKLLV	TPNYMKLLV
IPLYRNGDF	IPLYRNGDF
SPKIDRGWV	SPKIDRGWV
LPVRSWSYIV	LPVRSWSYI
RPISEKEENM	RPISEEENM
LPQRHHIML	LPQRHHIML
RPAKSGTVM	RPAKSGTVM
RPVPHWPKY	RPVPHWPKY
LPYVGDTSM	LPYVGDTSM
RPMPGTRKVM	RPMPGRKVM
LPFERTTVM	LPFERTTVM
ILRHPGFTL	ILRHPGFTL
LTRSGRRAL	LTRSGRRAL
FPWDMLFPA	FPWDMLFPA
VPHAKRQDV	VPHAKRQDV
VPGLPGTVL	VPGLPGTVL
LPVCAFSSA	LPVCAFSSA
GPLIAGGML	GPLIAGGML
IPRLLRTFL	IPRLLRTFL
KPDRAARVA	KPDRAARVA
APSASAFFGM	APSASFFGM
IPVTPASAA	IPVTPASAA
RTRGGVAAA	RTRGGVAAA
KPEVRIPVDL	KPEVRPVDL
LPYPYSSSA	LPYPYSSSA
KPNELSLAL	KPNELSLAL
LPEYGTLGL	LPEYGTLGL
TPRAKRGTAQ	TPRAKRGTA
TPQPKPGTRM	TPQPKGTRM
QPLIGSRAF	QPLIGSRAF
LAAVSVSPL	LAAVSVSPL
NPTTLIASL	NPTTLIASL
LPNVDLTTM	LPNVDLTTM
QPWTPVSSF	QPWTPVSSF
FPIPSSWAF	FPIPSSWAF
LPTTLFQPY	LPTTLFQPY
KPKALSEAF	KPKALSEAF
VPMHTDLEL	VPMHTDLEL
MPALTIACM	MPALTIACM
RPKSNIVLL	RPKSNIVLL
SPVRVPNYNL	SPVRVNYNL
GPSLRTTTA	GPSLRTTTA
YLRNAGAAM	YLRNAGAAM
SPIINRKGKV	SPIINKGKV
YPIVIAPAM	YPIVIAPAM
KPVSDLYTSM	KPVSDYTSM
RPHVPESAF	RPHVPESAF
IPDELIDVL	IPDELIDVL
RPLMKNTYL	RPLMKNTYL
RPGYHTQTAG	RPGYHTQTA
NPRMFLAM	NPRM-FLAM
GPWHLGKLEI	GPWHLKLEI
APRTLVLLL	APRTLVLLL
APRMPEAAP	APRMPEAAP
VPTNDHIPV	VPTNDHIPV
TPSMAMRCVG	TPSMAMRCV
APYMVGDVI	APYMVGDVI
TPSHYSGNI	TPSHYSGNI
KPKHLYVSM	KPKHLYVSM
YPRYPGVRC	YPRYPGVRC
RARNRVSTV	RARNRVSTV
SPLHVFVAV	SPLHVFVAV
TPSMTMRCVG	TPSMTMRCV
KPVIVPDIKL	KPVIVDIKL
LPTSITVPV	LPTSITVPV
APPPFRLPL	APPPFRLPL
RGRIGRTYL	RGRIGRTYL
MATFKMRPM	MATFKMRPM
KPRSPVVEL	KPRSPVVEL
APAHVSTIGV	APAHVSTIG
RPDTRHLRVL	RPDTRLRVL
RPTPKGTVM	RPTPKGTVM
RARIKTRLF	RARIKTRLF
GPRRAAWRI	GPRRAAWRI
LPHSSSHWL	LPHSSSHWL
SPYNSQNAV	SPYNSQNAV
QARQMVQAM	QARQMVQAM
IPMYNNYIL	IPMYNNYIL
LPATLAFHL	LPATLAFHL
HPRQFLAFL	HPRQFLAFL
KPKPAVRYAI	KPKPARYAI
KVRDRNFQL	KVRDRNFQL
FPVRPQVPQ	FPVRPQVPQ
SPAAAQKATL	SPAAAKATL
LPQHLTLRAQ	LPQHLTLRA
LPACVYGPAV	LPACVGPAV
MPVTHSSAA	MPVTHSSAA
YMKPGSSPL	YMKPGSSPL
WPAGRLVEA	WPAGRLVEA
VPFPVVNAM	VPFPVVNAM
MPRQKIIGPL	MPRQKIGPL
LPIRTTRHF	LPIRTTRHF
VPEFAKQYVL	VPEFAQYVL
GPMPVTHSSA	GPMPVHSSA
TPRRGTGTT	TPRRGTGTT
LLRQHWLSL	LLRQHWLSL
FPVRPQVPN	FPVRPQVPN
SPQPIRATV	SPQPIRATV
IPLQWIASA	IPLQWIASA
APSYGMRCV	APSYGMRCV
MPVTAASAA	MPVTAASAA
SPSGVYQCAM	SPSGVQCAM
RPMFAVGLL	RPMFAVGLL
RPAKSMDSL	RPAKSMDSL
WPYIASRTSI	WPYIARTSI
QPKPGTRMVM	QPKPGRMVM
IPTFLQEAL	IPTFLQEAL
RSRWSRKML	RSRWSRKML
FPWDLLFPA	FPWDLLFPA
KARNIISPV	KARNIISPV
SPASFFSSW	SPASFFSSW
YPQLSAIAL	YPQLSAIAL
WPVLGSEVL	WPVLGSEVL
GPPCSQRSKF	GPPCSRSKF
GPLRLFMAL	GPLRLFMAL
FIRYGDASL	FIRYGDASL
SPPEVERAVL	SPPEVRAVL
IPRNRDNLL	IPRNRDNLL
YPWAIFHPH	YPWAIFHPH
LPDDFMGCVL	LPDDFGCVL
LAHYIGTSL	LAHYIGTSL
LPFEKSIVM	LPFEKSIVM
QMRAVGQPL	QMRAVGQPL
