Data	Data aligned
FLIVLSVAL	FLIVLSVAL
RLRDLNQAV	RLRDLNQAV
YLIKLIEPV	YLIKLIEPV
KLFFAKCLV	KLFFAKCLV
KLIGITAIM	KLIGITAIM
MLGEQLFPL	MLGEQLFPL
VLYGPDTPV	VLYGPDTPV
FLCWGPFFL	FLCWGPFFL
RILGAVAKV	RILGAVAKV
FVNYDFTIV	FVNYDFTIV
SFYGYGFNV	SFYGYGFNV
YFSDVSAPV	YFSDVSAPV
IMIGVLVGV	IMIGVLVGV
TVSDYISEL	TVSDYISEL
YLVAYQATV	YLVAYQATV
YLAPGPVTV	YLAPGPVTV
RLDSYVRSL	RLDSYVRSL
LLSYYVVYV	LLSYYVVYV
RTFHIFYYL	RTFHIFYYL
ITMSAFLIV	ITMSAFLIV
FVSALCMFL	FVSALCMFL
TLMNVITLV	TLMNVITLV
LLYLITNYL	LLYLITNYL
TLWVDPYEV	TLWVDPYEV
KLQEMEGTV	KLQEMEGTV
VMAAVCLQI	VMAAVCLQI
IIDKDTNSV	IIDKDTNSV
NVDNLIMIV	NVDNLIMIV
QVNDVLHSV	QVNDVLHSV
LLLVAHYAI	LLLVAHYAI
RLITANPVV	RLITANPVV
FIISVISLV	FIISVISLV
IVMDNDDNI	IVMDNDDNI
LLYFILFFV	LLYFILFFV
ILCETCLIV	ILCETCLIV
GLLCLTLFV	GLLCLTLFV
AMVPLVMVI	AMVPLVMVI
LMDCIMFDA	LMDCIMFDA
AVVGFLLGV	AVVGFLLGV
MLDVDLHPA	MLDVDLHPA
KLLWFLTGT	KLLWFLTGT
LVIGFLFLA	LVIGFLFLA
GLNDYLHSV	GLNDYLHSV
YLKKKNHPL	YLKKKNHPL
IIFWFSLEI	IIFWFSLEI
MMHASTSPF	MMHASTSPF
LVMDKNHAI	LVMDKNHAI
AMDLVLAAV	AMDLVLAAV
QLWTALISL	QLWTALISL
LLVAAGMEA	LLVAAGMEA
QLLQANPIL	QLLQANPIL
LISIFLHLV	LISIFLHLV
VLFSGPSPL	VLFSGPSPL
ALSTGLIHL	ALSTGLIHL
FLIAYQPLL	FLIAYQPLL
TLPELNLSL	TLPELNLSL
CLALSDLLV	CLALSDLLV
LITMLSIIL	LITMLSIIL
FSYNVAYAI	FSYNVAYAI
SMVNGVVKL	SMVNGVVKL
LLPPLLEHL	LLPPLLEHL
RMILYLESV	RMILYLESV
MLLAFMTLV	MLLAFMTLV
TLACFVLAA	TLACFVLAA
FLLPSLATV	FLLPSLATV
EMADYIFFV	EMADYIFFV
YLSIYGFGV	YLSIYGFGV
ELAAHQKKI	ELAAHQKKI
TLNEDLLEI	TLNEDLLEI
WMLGTGVYL	WMLGTGVYL
FVIGGMTGV	FVIGGMTGV
IIMAINVFT	IIMAINVFT
FLICHNLRA	FLICHNLRA
SLFNTIAVL	SLFNTIAVL
GMAEDLQSL	GMAEDLQSL
ITSYKFESV	ITSYKFESV
YLYVDKNFI	YLYVDKNFI
IIMDEAHFL	IIMDEAHFL
ELACLLMYL	ELACLLMYL
STITNEFCV	STITNEFCV
YMDDVVLGA	YMDDVVLGA
IMAVGMVSI	IMAVGMVSI
MTPSPFYTV	MTPSPFYTV
LITNTIAGV	LITNTIAGV
ILDDNLYKV	ILDDNLYKV
LLLRQWLHV	LLLRQWLHV
SMINGVVKL	SMINGVVKL
ILISLTNEI	ILISLTNEI
SLQEEIAFL	SLQEEIAFL
LTYSQLMTL	LTYSQLMTL
FMAAKAAHL	FMAAKAAHL
SLYNTIAVL	SLYNTIAVL
LLSKNTFYL	LLSKNTFYL
WMIHTLEAL	WMIHTLEAL
ALSRKVAEL	ALSRKVAEL
SLYADSPSV	SLYADSPSV
YLSRTQRLA	YLSRTQRLA
IISTFHLSI	IISTFHLSI
SLYNAVATL	SLYNAVATL
FLLTRILTI	FLLTRILTI
GLYSLPHDL	GLYSLPHDL
KILSDENYL	KILSDENYL
RMPEAAPPV	RMPEAAPPV
MIFISSFLL	MIFISSFLL
ALAPSTMKI	ALAPSTMKI
GMGQKDSYV	GMGQKDSYV
IILTLIPRL	IILTLIPRL
RTWCRLLQV	RTWCRLLQV
KLFTHDIML	KLFTHDIML
IILLILSCI	IILLILSCI
LISGSTFSI	LISGSTFSI
YLFNAIETM	YLFNAIETM
FLAHLQWFA	FLAHLQWFA
FLSHNFTLV	FLSHNFTLV
GLRDCTMLV	GLRDCTMLV
GLADAFILL	GLADAFILL
RLVDFFPDI	RLVDFFPDI
KLVVVAVGV	KLVVVAVGV
FLLLADARV	FLLLADARV
GAWCYDYTV	GAWCYDYTV
KLNKMTVEL	KLNKMTVEL
KLSDSKITV	KLSDSKITV
ILIEGIFFV	ILIEGIFFV
YTLNDAPYI	YTLNDAPYI
RLEARIAQL	RLEARIAQL
IISYIILFI	IISYIILFI
LQAAIFHAL	LQAAIFHAL
TLDSQVMSL	TLDSQVMSL
VMCGGSLYV	VMCGGSLYV
LLLNTTLTV	LLLNTTLTV
WVMDTLNGI	WVMDTLNGI
RLMKQDFSV	RLMKQDFSV
MTLWYMWQV	MTLWYMWQV
SLDSLVHLL	SLDSLVHLL
FLGAGALAV	FLGAGALAV
TILLGIFFL	TILLGIFFL
RLTSNEIFI	RLTSNEIFI
AMLHWSLIL	AMLHWSLIL
KLNDWDFVV	KLNDWDFVV
HLYSHPIIL	HLYSHPIIL
RLVSGLVGA	RLVSGLVGA
KTIIDPDFV	KTIIDPDFV
VLQQNNSFI	VLQQNNSFI
KLSYGIATV	KLSYGIATV
FLSNVGHYV	FLSNVGHYV
KLQVELDNV	KLQVELDNV
FLPPQIPVI	FLPPQIPVI
ALIHHNTHL	ALIHHNTHL
FTLIDIWFL	FTLIDIWFL
YIDAYVSRL	YIDAYVSRL
SLSLHPLYV	SLSLHPLYV
NTSAGFPYV	NTSAGFPYV
LLYDANYFV	LLYDANYFV
ILQMREIIT	ILQMREIIT
ALYGSVPVL	ALYGSVPVL
FVFRSPFIV	FVFRSPFIV
DLMEFIDGI	DLMEFIDGI
AAAATCALV	AAAATCALV
GLFDFVNFV	GLFDFVNFV
KQSSFLSSL	KQSSFLSSL
AMFWSVPTV	AMFWSVPTV
ALWEIQQVV	ALWEIQQVV
TLVDLCFWS	TLVDLCFWS
VAANIVLTV	VAANIVLTV
LLDAHIPQL	LLDAHIPQL
FTLGIMAIA	FTLGIMAIA
QLNMEKREV	QLNMEKREV
NVLAWLYAA	NVLAWLYAA
FLKDVEPLL	FLKDVEPLL
RLNKRSYLI	RLNKRSYLI
KMMLFYMDL	KMMLFYMDL
FMHSAAPIT	FMHSAAPIT
FLNEDHWFS	FLNEDHWFS
AMTHLSPAL	AMTHLSPAL
SLSTKLKQV	SLSTKLKQV
SMELPSFGV	SMELPSFGV
SVYDFFVWL	SVYDFFVWL
QLEELEDEL	QLEELEDEL
NLLDSYFVV	NLLDSYFVV
LTLDEQIFV	LTLDEQIFV
GLLGWSPQA	GLLGWSPQA
RLYDLTRYA	RLYDLTRYA
SILEYAKSI	SILEYAKSI
YLDAYNMMI	YLDAYNMMI
VLAPYMPDV	VLAPYMPDV
FVFAPTHGL	FVFAPTHGL
GLDDSALDA	GLDDSALDA
VLSNTSTAV	VLSNTSTAV
GILGFVFTL	GILGFVFTL
GLPESTPSL	GLPESTPSL
ILPILVLAL	ILPILVLAL
QLLDVKLAL	QLLDVKLAL
YLFRIVSTV	YLFRIVSTV
ELFGEAFEV	ELFGEAFEV
ALCRWGLLL	ALCRWGLLL
KVAELVHFL	KVAELVHFL
ILLLDQVLV	ILLLDQVLV
LQFGFGWFS	LQFGFGWFS
FTLDADLGI	FTLDADLGI
GLILFVLAL	GLILFVLAL
YLVAKQATV	YLVAKQATV
ILSLETVKM	ILSLETVKM
SLENFRAYV	SLENFRAYV
FISGIQYLA	FISGIQYLA
KLQKDLEGL	KLQKDLEGL
FLEQQNKIL	FLEQQNKIL
FVDGVPFVV	FVDGVPFVV
YHLGGIEGL	YHLGGIEGL
AMALSIVSL	AMALSIVSL
FISSFLLPL	FISSFLLPL
RVFNEYGFV	RVFNEYGFV
LLGCIITSL	LLGCIITSL
FLSLMSLSI	FLSLMSLSI
GLDPTGVAV	GLDPTGVAV
KSGLFQFFV	KSGLFQFFV
MLLTFLTSL	MLLTFLTSL
YLMKDKLNI	YLMKDKLNI
SMFERDFHF	SMFERDFHF
YLPAIVREA	YLPAIVREA
GILTVVWTA	GILTVVWTA
YIWIKNLET	YIWIKNLET
VILFIMFML	VILFIMFML
KTMAVTYEL	KTMAVTYEL
VVPYEPPEV	VVPYEPPEV
VLMEAQQGI	VLMEAQQGI
MLNGIMYRL	MLNGIMYRL
NLSWLSLDV	NLSWLSLDV
LLDVAPLSL	LLDVAPLSL
RLLGSLNST	RLLGSLNST
LMLVAHYAI	LMLVAHYAI
RILPYTFKI	RILPYTFKI
KMLDPRQGL	KMLDPRQGL
YLISIFLHL	YLISIFLHL
IMYGGVFSL	IMYGGVFSL
AAGIGILTV	AAGIGILTV
ILLAELEQL	ILLAELEQL
AMHYIRHRA	AMHYIRHRA
FIIEVSNCV	FIIEVSNCV
FTFEWNGRI	FTFEWNGRI
WMMAMKYPI	WMMAMKYPI
HMIDKLFYV	HMIDKLFYV
FAAELTIGV	FAAELTIGV
VLMIKALEL	VLMIKALEL
LVLSVNPYV	LVLSVNPYV
FLLLTSIPI	FLLLTSIPI
LLSAINFKI	LLSAINFKI
SLLSVLLSM	SLLSVLLSM
KAACWWAGI	KAACWWAGI
IILEFFLMV	IILEFFLMV
VLDTTLYAV	VLDTTLYAV
CIDGKWNPV	CIDGKWNPV
RIFYNILEI	RIFYNILEI
ALFEDYPGC	ALFEDYPGC
FLWGPRALV	FLWGPRALV
ILPDKIDGL	ILPDKIDGL
WLIEPCKLL	WLIEPCKLL
RTNDLTALL	RTNDLTALL
QLLSAVDYI	QLLSAVDYI
FLLSLGIHL	FLLSLGIHL
TMKEKSWLV	TMKEKSWLV
QLPLESDAV	QLPLESDAV
SLYPPCLFK	SLYPPCLFK
KVHADDIPV	KVHADDIPV
RLARCLTPA	RLARCLTPA
FIASAPQQL	FIASAPQQL
FVNHRFTLV	FVNHRFTLV
RTLDKVLEV	RTLDKVLEV
VIACLLVAV	VIACLLVAV
TLYDFDYYI	TLYDFDYYI
ILAADLEKL	ILAADLEKL
PLWESATEV	PLWESATEV
MSDIFASEV	MSDIFASEV
FLIVSLCPT	FLIVSLCPT
NLDTSPFFV	NLDTSPFFV
KLTSYSAGL	KLTSYSAGL
LLASMVEEA	LLASMVEEA
ITAIYVFCI	ITAIYVFCI
KLFTIAMWL	KLFTIAMWL
FLKDVMESM	FLKDVMESM
KTISVVTLL	KTISVVTLL
FLYVVCSLA	FLYVVCSLA
YILRGLLEA	YILRGLLEA
KIAPGIADI	KIAPGIADI
ILSCIFAFI	ILSCIFAFI
SLFLHLVGI	SLFLHLVGI
FLLMDALKL	FLLMDALKL
FLFQLNDTI	FLFQLNDTI
VLPVPGASV	VLPVPGASV
KLAEIFQPF	KLAEIFQPF
NLPEDIKRV	NLPEDIKRV
FMTATPPGA	FMTATPPGA
SMGLITIAV	SMGLITIAV
FLYGALLLA	FLYGALLLA
SLLTFMIAA	SLLTFMIAA
ILMDTICGT	ILMDTICGT
YLSSWTPVV	YLSSWTPVV
MLFDQGTLV	MLFDQGTLV
IMAHCILDL	IMAHCILDL
FIADIGIGV	FIADIGIGV
MMFDAMGAL	MMFDAMGAL
FLQQSIFRF	FLQQSIFRF
RVYEALYYV	RVYEALYYV
QLLKILDNL	QLLKILDNL
VLPDVFIRC	VLPDVFIRC
IMLEGETKL	IMLEGETKL
IVLEFFMMV	IVLEFFMMV
LLAGLVSLL	LLAGLVSLL
LLFNKVTLA	LLFNKVTLA
YLPEVISTI	YLPEVISTI
WLVIGVAFL	WLVIGVAFL
LILNFLDWI	LILNFLDWI
YLMPYSVYI	YLMPYSVYI
SIDQKKSYV	SIDQKKSYV
AMYVAIQAV	AMYVAIQAV
LVPFVQWFV	LVPFVQWFV
AQMGTLLIA	AQMGTLLIA
ALCKVTVPT	ALCKVTVPT
SLSAYIIRV	SLSAYIIRV
MLYVIFPGT	MLYVIFPGT
MLYQLLEAV	MLYQLLEAV
FAFRDLCIV	FAFRDLCIV
ALATFTVNI	ALATFTVNI
GMSWITQGL	GMSWITQGL
FLYALALLL	FLYALALLL
YMLWNSWLS	YMLWNSWLS
IMAFILGII	IMAFILGII
FMPKVNFEV	FMPKVNFEV
SCINRCFYV	SCINRCFYV
FLPKAAFAL	FLPKAAFAL
SMHYKLDEV	SMHYKLDEV
NLSNCVHPA	NLSNCVHPA
TINNLKMML	TINNLKMML
SLLMWITQC	SLLMWITQC
SLQECVKMA	SLQECVKMA
MVVKVNAAL	MVVKVNAAL
AMQTMLFTM	AMQTMLFTM
FVASFRLFA	FVASFRLFA
LIFILLTAV	LIFILLTAV
FVVDTTPPL	FVVDTTPPL
GLRQQLEDI	GLRQQLEDI
RTCSNWVPL	RTCSNWVPL
LLSCLTTPA	LLSCLTTPA
RLRQDTEDI	RLRQDTEDI
TSLGLLYTV	TSLGLLYTV
FLCTADAAV	FLCTADAAV
YLVTRHADV	YLVTRHADV
ILKKIIPTL	ILKKIIPTL
FVTIYSHLL	FVTIYSHLL
GLAWQAASV	GLAWQAASV
ILATLNTLI	ILATLNTLI
FLDWIKDIM	FLDWIKDIM
FANNKFTLV	FANNKFTLV
LQYDLWNVV	LQYDLWNVV
GTYAVNIHV	GTYAVNIHV
VLAGWLFHV	VLAGWLFHV
KIILFLTLI	KIILFLTLI
TLLGDGPVV	TLLGDGPVV
FLRDNLYHV	FLRDNLYHV
MTSERTLAV	MTSERTLAV
FTSSFYNYV	FTSSFYNYV
ILIRLTLLL	ILIRLTLLL
SIMETIDPV	SIMETIDPV
LITWLIDYV	LITWLIDYV
LLAQFTSAI	LLAQFTSAI
IMSSSLFNL	IMSSSLFNL
DLAEWVPRV	DLAEWVPRV
RMAWGGSYI	RMAWGGSYI
AMMWRIAQL	AMMWRIAQL
VIDEILFKV	VIDEILFKV
GLHTEFQTV	GLHTEFQTV
GMSIVCIVA	GMSIVCIVA
MIIIVIAII	MIIIVIAII
VLWAHGFEL	VLWAHGFEL
ILSPFLPLL	ILSPFLPLL
QLFEDNYAL	QLFEDNYAL
MIDDSIEGI	MIDDSIEGI
VVLGVVFGI	VVLGVVFGI
ALVSGTATA	ALVSGTATA
MLWMADVPL	MLWMADVPL
LLAPGPLFV	LLAPGPLFV
YLAKLTALV	YLAKLTALV
NCLTLLLSV	NCLTLLLSV
MMNERDVSV	MMNERDVSV
LLILCVTQV	LLILCVTQV
KINEMVDEL	KINEMVDEL
NLADQLIHL	NLADQLIHL
CAPHRVSGV	CAPHRVSGV
VLTALLAGL	VLTALLAGL
MLYQHLLPL	MLYQHLLPL
YLPLSVFII	YLPLSVFII
KLVYLIVGV	KLVYLIVGV
YMNGTMSQV	YMNGTMSQV
TLIGDCATV	TLIGDCATV
AMTMFYPGV	AMTMFYPGV
MLLAYLVRI	MLLAYLVRI
FVGALSFSI	FVGALSFSI
SLTECPTFL	SLTECPTFL
FLKIKVTAA	FLKIKVTAA
AVVYSTCTV	AVVYSTCTV
VMAARPMVV	VMAARPMVV
LVLGTLEEV	LVLGTLEEV
QLANAIFKL	QLANAIFKL
LMIERFVSL	LMIERFVSL
YLLPGFVLT	YLLPGFVLT
FLIDGPETA	FLIDGPETA
SLYQTVATL	SLYQTVATL
GLLGSPVRA	GLLGSPVRA
GLFQFFVFL	GLFQFFVFL
KLLIVLTCI	KLLIVLTCI
LLGRNSFEV	LLGRNSFEV
LLEIHQYPA	LLEIHQYPA
FLLAKLTDI	FLLAKLTDI
WLLGFIKCI	WLLGFIKCI
ILFIMFMLI	ILFIMFMLI
ILLWEIPDV	ILLWEIPDV
GLISLILQI	GLISLILQI
FIIDNFGSV	FIIDNFGSV
KTIECSKEL	KTIECSKEL
VLLDYQGML	VLLDYQGML
PLNEGIMAV	PLNEGIMAV
LIALSVLAV	LIALSVLAV
WLGAAITLV	WLGAAITLV
KVTRFYFNM	KVTRFYFNM
LLLLGLWGL	LLLLGLWGL
LMLLALIAV	LMLLALIAV
YITALNHLV	YITALNHLV
LMWYELSKI	LMWYELSKI
QIITLTAFV	QIITLTAFV
SLNLTIVSV	SLNLTIVSV
YLVAYQAKV	YLVAYQAKV
SLFSLLLVI	SLFSLLLVI
ALYKGFQFI	ALYKGFQFI
ALPHIIDEV	ALPHIIDEV
RLDALVVAA	RLDALVVAA
KIWEELSVL	KIWEELSVL
WAPEGDIRL	WAPEGDIRL
CLSDLLGFL	CLSDLLGFL
GTTSLFLHL	GTTSLFLHL
TLLYATVEV	TLLYATVEV
RQLLWRYQI	RQLLWRYQI
ALDQACFRI	ALDQACFRI
ALVEICTEM	ALVEICTEM
QLQCHQIAI	QLQCHQIAI
QIFEVYWYL	QIFEVYWYL
QLAKLMATL	QLAKLMATL
LLLTLLATV	LLLTLLATV
TMADLVYAL	TMADLVYAL
SMPDFDLHL	SMPDFDLHL
FLHDVENFL	FLHDVENFL
SLMAFTASI	SLMAFTASI
YLYASFCTV	YLYASFCTV
SMAMTCIAV	SMAMTCIAV
QLSCISTYV	QLSCISTYV
VMSELFDTL	VMSELFDTL
SLQPRSHSV	SLQPRSHSV
PLLPIFFCL	PLLPIFFCL
NMCNSDVSV	NMCNSDVSV
NVIGLIVIL	NVIGLIVIL
AMFTTMYNI	AMFTTMYNI
YLACELLPA	YLACELLPA
SISSVLTIL	SISSVLTIL
ALAKAAAAV	ALAKAAAAV
YTDEVYDYL	YTDEVYDYL
VLAAGVLVV	VLAAGVLVV
GLSRYVPRL	GLSRYVPRL
SVSDFDLRI	SVSDFDLRI
KLSCAVHLI	KLSCAVHLI
FIRYGDASL	FIRYGDASL
FANHNFTLV	FANHNFTLV
LMGTITLNA	LMGTITLNA
LMQWWSDYV	LMQWWSDYV
YMPTVIEEL	YMPTVIEEL
ALLEDPVGT	ALLEDPVGT
ALDVYNGLL	ALDVYNGLL
RVYAELAAL	RVYAELAAL
AQMVWIHGV	AQMVWIHGV
YLFTFTIYT	YLFTFTIYT
AMLQLDPNA	AMLQLDPNA
WLYGYNFII	WLYGYNFII
ILTDGPERV	ILTDGPERV
AVLADFSLV	AVLADFSLV
LMTLYQIQV	LMTLYQIQV
AIYDTMQYV	AIYDTMQYV
SMFYGIFPS	SMFYGIFPS
IMLKANFSV	IMLKANFSV
FAAAFFPAV	FAAAFFPAV
LLLDDFVEI	LLLDDFVEI
NLWNTFTRL	NLWNTFTRL
TLWCSPIKV	TLWCSPIKV
SIYECITFL	SIYECITFL
KVDDTFYYV	KVDDTFYYV
MMQVWIQPL	MMQVWIQPL
GMLPVCPLI	GMLPVCPLI
ATVGIMIGV	ATVGIMIGV
SLLPAIVEL	SLLPAIVEL
TVIKTLLEV	TVIKTLLEV
ALLSCIRNA	ALLSCIRNA
NLDISSVQL	NLDISSVQL
RQIFIHYSV	RQIFIHYSV
LLMGTLGIV	LLMGTLGIV
SMDTLLFFL	SMDTLLFFL
RLQHLVAEI	RLQHLVAEI
ALSLAAVLV	ALSLAAVLV
FLLRGPFEA	FLLRGPFEA
LTAAVLMLV	LTAAVLMLV
LLNMRDLIV	LLNMRDLIV
LLMALPHQA	LLMALPHQA
RVATENIAV	RVATENIAV
AIQIQMFEA	AIQIQMFEA
NLNQVIQSV	NLNQVIQSV
YALTVVWLL	YALTVVWLL
ILTGLNYEA	ILTGLNYEA
SLSSQLSNL	SLSSQLSNL
DIIDFLEGA	DIIDFLEGA
LMIFISSFL	LMIFISSFL
YIWKSYVHI	YIWKSYVHI
GLSQFTHTV	GLSQFTHTV
FLAFVVFLL	FLAFVVFLL
YIIPCILIL	YIIPCILIL
KLYGYASLT	KLYGYASLT
ELMESRMRI	ELMESRMRI
ILHCANFNV	ILHCANFNV
KVYGRYSAV	KVYGRYSAV
ALLSRFFNM	ALLSRFFNM
IIPFLLVLV	IIPFLLVLV
KTITTCYLM	KTITTCYLM
VLYCVHQRV	VLYCVHQRV
NISTILYFT	NISTILYFT
VIVIYIFTV	VIVIYIFTV
LLFLMSFTI	LLFLMSFTI
IVVALSSLV	IVVALSSLV
SLFGAAVSL	SLFGAAVSL
MMWYWGPSL	MMWYWGPSL
FIPQYLSAV	FIPQYLSAV
YLEGHGFRF	YLEGHGFRF
YLPRFLFGV	YLPRFLFGV
FMQEIPTFL	FMQEIPTFL
SLYDVEFDA	SLYDVEFDA
QLMAEKLQL	QLMAEKLQL
RTAWWVWCV	RTAWWVWCV
NLLLLFVTI	NLLLLFVTI
FLLRSIIVA	FLLRSIIVA
HLGNVKYLV	HLGNVKYLV
LLSGAGEHL	LLSGAGEHL
RLLYPDYQI	RLLYPDYQI
AQFAPSASA	AQFAPSASA
YQVEGATRV	YQVEGATRV
ILASFSAST	ILASFSAST
LVVTAIVYV	LVVTAIVYV
RMQFSSFTV	RMQFSSFTV
HLMFYTLPI	HLMFYTLPI
ILSDENYLL	ILSDENYLL
LMYDIINSV	LMYDIINSV
MLFTKFFYL	MLFTKFFYL
YLIPAVTSL	YLIPAVTSL
YLSEGDMAA	YLSEGDMAA
VLSFCAFAV	VLSFCAFAV
QMTSTFIML	QMTSTFIML
RIIDSEVVV	RIIDSEVVV
IILVIIVVI	IILVIIVVI
GLFGKGSLV	GLFGKGSLV
SLLSLEHTL	SLLSLEHTL
RQLLFVVEV	RQLLFVVEV
SIDIETESV	SIDIETESV
RLDKVEAEV	RLDKVEAEV
CMAFTIPSI	CMAFTIPSI
FMMVLPGAA	FMMVLPGAA
FLHKRFTLV	FLHKRFTLV
YMKPGSSPL	YMKPGSSPL
GLYPQLSAI	GLYPQLSAI
LIDFYLCFL	LIDFYLCFL
SMIGLCACV	SMIGLCACV
KLKSLYNTV	KLKSLYNTV
RLYEWQHVS	RLYEWQHVS
ALQNVMISI	ALQNVMISI
GMLFVNDLM	GMLFVNDLM
TMGPHPAGV	TMGPHPAGV
ALLDRDCRV	ALLDRDCRV
GLLQFIVFL	GLLQFIVFL
YQSFLFWFL	YQSFLFWFL
RLAEAVVSA	RLAEAVVSA
FLARAIVFV	FLARAIVFV
YLVAYQATI	YLVAYQATI
KLVDICDRI	KLVDICDRI
ALEAKIAQL	ALEAKIAQL
FANTEFTLV	FANTEFTLV
LLLFHETGV	LLLFHETGV
YLSGANLNL	YLSGANLNL
AAAKAAAAV	AAAKAAAAV
ILASIIDYV	ILASIIDYV
TMRDDLPLV	TMRDDLPLV
FVDTMSIYI	FVDTMSIYI
GMFNMLSTV	GMFNMLSTV
ILSSLGLPV	ILSSLGLPV
FTNDVSFLA	FTNDVSFLA
ILDNAAKYV	ILDNAAKYV
VTTEVAFGL	VTTEVAFGL
LITNYLPSV	LITNYLPSV
RLLSPTTIV	RLLSPTTIV
FCSDALTLI	FCSDALTLI
LLDVPTAAV	LLDVPTAAV
MLLIAQAEA	MLLIAQAEA
FVDFVIHGL	FVDFVIHGL
WLLQITVLL	WLLQITVLL
FMYFCEQKL	FMYFCEQKL
YVMTMILFL	YVMTMILFL
LLNPCLINV	LLNPCLINV
FLSTLPSDV	FLSTLPSDV
WTLAKPDFV	WTLAKPDFV
VLNPYMPSV	VLNPYMPSV
TMLEDHEFV	TMLEDHEFV
CTMERTNDL	CTMERTNDL
WQTDTTIPL	WQTDTTIPL
SLMEHWALG	SLMEHWALG
FLAVFQSAT	FLAVFQSAT
SLHSLSVET	SLHSLSVET
GMQFDKVYL	GMQFDKVYL
YMFFVIKNL	YMFFVIKNL
FMYSDFHFI	FMYSDFHFI
YMHGSIHEV	YMHGSIHEV
KMAVEVGSI	KMAVEVGSI
GMIPFFDFA	GMIPFFDFA
FLFAVGFYL	FLFAVGFYL
YLRLYIILA	YLRLYIILA
FLPRVFSAV	FLPRVFSAV
RILGAGCFV	RILGAGCFV
HCIDKTPGL	HCIDKTPGL
LVITINYFL	LVITINYFL
FLKDVMVEI	FLKDVMVEI
GLAGGAATA	GLAGGAATA
YLACLAAVI	YLACLAAVI
NVIEDITFL	NVIEDITFL
RALLNMIGM	RALLNMIGM
FLTREILWA	FLTREILWA
SLGQYIYET	SLGQYIYET
IIAIVFVFI	IIAIVFVFI
VLIAGIILL	VLIAGIILL
WLIDYVEDT	WLIDYVEDT
YAMCLNTFV	YAMCLNTFV
VLVKSPNHV	VLVKSPNHV
IMFTCMDPL	IMFTCMDPL
ILAGYGAGV	ILAGYGAGV
KSSFFVWVI	KSSFFVWVI
GALDVSASV	GALDVSASV
ILTVILGVL	ILTVILGVL
YMPYVFTLL	YMPYVFTLL
YLYPGPVTA	YLYPGPVTA
LLKDLMPFV	LLKDLMPFV
YLWPGPVTV	YLWPGPVTV
EMVELRILL	EMVELRILL
ELQKFSFKI	ELQKFSFKI
SLYNTVAVL	SLYNTVAVL
LVLQAGFFL	LVLQAGFFL
VLTDFKTWL	VLTDFKTWL
LLDKQQFEL	LLDKQQFEL
DTVFDYYVL	DTVFDYYVL
AMIDRLHQT	AMIDRLHQT
NIYSALMTL	NIYSALMTL
ALLFLMSFT	ALLFLMSFT
ILNAMITKI	ILNAMITKI
YLAPGPVTA	YLAPGPVTA
FLFLAWIML	FLFLAWIML
LLYILRYIV	LLYILRYIV
LVGPTPVNI	LVGPTPVNI
FILHRLHEI	FILHRLHEI
ALDISFTGA	ALDISFTGA
FTGITLFLL	FTGITLFLL
KLLGQINLV	KLLGQINLV
ILAIIFLVL	ILAIIFLVL
AVGIGLRLV	AVGIGLRLV
FLSHDFTLV	FLSHDFTLV
SLVKPTVYV	SLVKPTVYV
YLVAYQATF	YLVAYQATF
IITILQDIV	IITILQDIV
KLQPSDTLL	KLQPSDTLL
KIFGSLAFL	KIFGSLAFL
STYPGNTFV	STYPGNTFV
SLTTIGTIA	SLTTIGTIA
LNIMNKLNI	LNIMNKLNI
KMHDVIAPA	KMHDVIAPA
ILKEPVHGV	ILKEPVHGV
VLAWLYAAV	VLAWLYAAV
RLLQSFLKV	RLLQSFLKV
MMISAGFSL	MMISAGFSL
QLQDTQELL	QLQDTQELL
ALSALLTKL	ALSALLTKL
LMIEYNLLT	LMIEYNLLT
KMDIGVPLL	KMDIGVPLL
SLRNWIATL	SLRNWIATL
YLSGTDDEV	YLSGTDDEV
ALSMGINTV	ALSMGINTV
KQFCLSILL	KQFCLSILL
SLKERIDML	SLKERIDML
TLIPRLFAL	TLIPRLFAL
MVIFRLMRT	MVIFRLMRT
CMFGVVSPA	CMFGVVSPA
ALAGNHWHV	ALAGNHWHV
TLNTLITLI	TLNTLITLI
WLGETFHGL	WLGETFHGL
VLWKSYPLV	VLWKSYPLV
DLADQLIHL	DLADQLIHL
ELIKELTTL	ELIKELTTL
KMYEYVFKG	KMYEYVFKG
FVVWALLGL	FVVWALLGL
YQTYVSPGA	YQTYVSPGA
KLGNLLLLI	KLGNLLLLI
KVGNCDETV	KVGNCDETV
MQFVDRFVV	MQFVDRFVV
LLMLCLHHA	LLMLCLHHA
ALHTALATV	ALHTALATV
YMIKKLLKI	YMIKKLLKI
ILQYDLWNV	ILQYDLWNV
NLVPMVATV	NLVPMVATV
FTSDYPFYV	FTSDYPFYV
FIYSIMETI	FIYSIMETI
GIAWYVTSI	GIAWYVTSI
YMMDGNECP	YMMDGNECP
KLLYAAEMV	KLLYAAEMV
AVLAFVALI	AVLAFVALI
FLWEDQTLL	FLWEDQTLL
SISEINEWL	SISEINEWL
VVFLHVTYV	VVFLHVTYV
IVFVFILTA	IVFVFILTA
MIIGEPIIV	MIIGEPIIV
VIFILLMLV	VIFILLMLV
KLIEYSDFA	KLIEYSDFA
LLTYFCFVA	LLTYFCFVA
QIFNIISYI	QIFNIISYI
YTMDGEYRL	YTMDGEYRL
SVRDRLARL	SVRDRLARL
TIAHINTLI	TIAHINTLI
IVVPVIDRL	IVVPVIDRL
IMGAVLIWV	IMGAVLIWV
NLYKVYNGI	NLYKVYNGI
AAAWYLWEV	AAAWYLWEV
KMHFYLPGA	KMHFYLPGA
VIPDELIDV	VIPDELIDV
LLWFHISCL	LLWFHISCL
LLQYWSQEL	LLQYWSQEL
SLPITVYYA	SLPITVYYA
GLVFRFSEV	GLVFRFSEV
ALVALVITI	ALVALVITI
LMMSCISCI	LMMSCISCI
YMPSVVETL	YMPSVVETL
MLNRVQILM	MLNRVQILM
FLNISWFYI	FLNISWFYI
KMGKAGYVT	KMGKAGYVT
VLAGIFAGV	VLAGIFAGV
FLPSDFFPS	FLPSDFFPS
ETDLNQWMV	ETDLNQWMV
GLFLTTEAV	GLFLTTEAV
GLQDCTMLV	GLQDCTMLV
MLNFSIYSV	MLNFSIYSV
LLFNEKLKV	LLFNEKLKV
VLQAGITRV	VLQAGITRV
QLWPEEIGV	QLWPEEIGV
HIAGSLAVV	HIAGSLAVV
FVNYDFALV	FVNYDFALV
GMFGGCFAA	GMFGGCFAA
LLAGFMAYM	LLAGFMAYM
FLQDVMNIL	FLQDVMNIL
KLIEPVNAI	KLIEPVNAI
FLTGTFVTA	FLTGTFVTA
FMDPGIFPR	FMDPGIFPR
KLLLWFNYL	KLLLWFNYL
LLALQQLEV	LLALQQLEV
DMYDQQLSV	DMYDQQLSV
LLDDLGFSA	LLDDLGFSA
SLYNTVATL	SLYNTVATL
LLNNYDVLV	LLNNYDVLV
HADDIPVPV	HADDIPVPV
HLYQGCQVV	HLYQGCQVV
EMDKDDESL	EMDKDDESL
QEPGIFCAI	QEPGIFCAI
ALQEAYYRA	ALQEAYYRA
FLQEALNIA	FLQEALNIA
LVMAFIAFL	LVMAFIAFL
SLSVSLVLV	SLSVSLVLV
KVIQYLAYV	KVIQYLAYV
GLIEEMASA	GLIEEMASA
VMNPLGLNV	VMNPLGLNV
LLWKGEGAV	LLWKGEGAV
FLHTTFIDV	FLHTTFIDV
ALAAATPMV	ALAAATPMV
ILSDDMLNI	ILSDDMLNI
YMDDVVLGV	YMDDVVLGV
FIDILLFVI	FIDILLFVI
NLPSSENYM	NLPSSENYM
YMMGIEYGL	YMMGIEYGL
ALLEACLRV	ALLEACLRV
LLYAHINAL	LLYAHINAL
YLYALIYFL	YLYALIYFL
FTGEYLLRL	FTGEYLLRL
TLGIVCPIC	TLGIVCPIC
RAWGRRLMI	RAWGRRLMI
RLYDYFTRV	RLYDYFTRV
GLLATPLFL	GLLATPLFL
NLAADLTQI	NLAADLTQI
SLKDVLVSV	SLKDVLVSV
HLEWLLGFI	HLEWLLGFI
FIPIIYSKA	FIPIIYSKA
AIIRILQQL	AIIRILQQL
NASYITPYV	NASYITPYV
GLTEVFGST	GLTEVFGST
DLMGYIPLV	DLMGYIPLV
SIDHCSSFI	SIDHCSSFI
SMSQELAEL	SMSQELAEL
KVFFVNWFR	KVFFVNWFR
GLFQEAYPL	GLFQEAYPL
YITDYSNDI	YITDYSNDI
SLFNTVAVL	SLFNTVAVL
ITMGSLFFV	ITMGSLFFV
SMMSMYGKA	SMMSMYGKA
SLVSKHWEL	SLVSKHWEL
VLRDDLCEA	VLRDDLCEA
FQLIFFLTL	FQLIFFLTL
GLYSSTVPV	GLYSSTVPV
YTIERIFNA	YTIERIFNA
ILVGYMSNL	ILVGYMSNL
RIQQYMFFM	RIQQYMFFM
ALAKNASEL	ALAKNASEL
ILIEGVFFA	ILIEGVFFA
VLSYVIGLL	VLSYVIGLL
FMSMVSHEL	FMSMVSHEL
SLLTYAGPI	SLLTYAGPI
SLPPNFSSL	SLPPNFSSL
RLAVYIDKV	RLAVYIDKV
FLTPLSVTL	FLTPLSVTL
VLADDLLEA	VLADDLLEA
VIADYNYKL	VIADYNYKL
SMFLMTATL	SMFLMTATL
QLMCQPILL	QLMCQPILL
ALLADKFPV	ALLADKFPV
LLFLVLIML	LLFLVLIML
TIMGVIFLI	TIMGVIFLI
FMFNELLAL	FMFNELLAL
GLSRYVARL	GLSRYVARL
SILSPFLPL	SILSPFLPL
TLDNILGIL	TLDNILGIL
FMECNLNEL	FMECNLNEL
FLDNECHTI	FLDNECHTI
VVHGYFTEV	VVHGYFTEV
RLLGTFTWT	RLLGTFTWT
SQGRGWFLL	SQGRGWFLL
RLWHYPCTI	RLWHYPCTI
FLSRVFFCV	FLSRVFFCV
RQASLSISV	RQASLSISV
LLSIIFFPA	LLSIIFFPA
VLFRLENHA	VLFRLENHA
SLYFGGICV	SLYFGGICV
TQFGVPFVL	TQFGVPFVL
RLPPNTFFA	RLPPNTFFA
YLLGDSDSV	YLLGDSDSV
FLASLVVLA	FLASLVVLA
NISLPLYTV	NISLPLYTV
VLFIHPLDA	VLFIHPLDA
IILVAVPHV	IILVAVPHV
YLDQVPFSV	YLDQVPFSV
FANHAFTLV	FANHAFTLV
RLIQNSITI	RLIQNSITI
YMYQYIQEL	YMYQYIQEL
YLDADREFL	YLDADREFL
ILNAMIAKI	ILNAMIAKI
FTQKSLFPI	FTQKSLFPI
FGLLPEHYV	FGLLPEHYV
CISSCNPNL	CISSCNPNL
VELQIGWTV	VELQIGWTV
YMIYMSGLA	YMIYMSGLA
RLRSSVPGV	RLRSSVPGV
LLSGLPTYA	LLSGLPTYA
YIDALAKNA	YIDALAKNA
VLQAVGACV	VLQAVGACV
FLAFLLFLV	FLAFLLFLV
VLNPYMPTV	VLNPYMPTV
EVGIKSVVV	EVGIKSVVV
HLINKLLST	HLINKLLST
TTWEDVPYL	TTWEDVPYL
SLYNTAATL	SLYNTAATL
YLSAKVYML	YLSAKVYML
ILFQVPFSV	ILFQVPFSV
LLTFWNPPT	LLTFWNPPT
ILYAAFLWL	ILYAAFLWL
KLLPVHYYM	KLLPVHYYM
RLASLLTYA	RLASLLTYA
NTIDQTANV	NTIDQTANV
LLVAPMPTA	LLVAPMPTA
TFWMGSHEV	TFWMGSHEV
LLYDLSTTA	LLYDLSTTA
YLKIGTLLV	YLKIGTLLV
ALLDLGWTI	ALLDLGWTI
YLGAFLSVL	YLGAFLSVL
KLLHHILPI	KLLHHILPI
GLDLENLYA	GLDLENLYA
FLWLLWPVT	FLWLLWPVT
AILGVLATL	AILGVLATL
SLFGQRIEV	SLFGQRIEV
YTFLYNFWT	YTFLYNFWT
VLSDFKTWL	VLSDFKTWL
TLHEYMLDL	TLHEYMLDL
FVGKTVWFV	FVGKTVWFV
LLFGYPVAV	LLFGYPVAV
NILMDSIFV	NILMDSIFV
YLDMVLAFL	YLDMVLAFL
LAMSTTISV	LAMSTTISV
CLPACVYGL	CLPACVYGL
RLCAYCCNI	RLCAYCCNI
RLIQNSLTI	RLIQNSLTI
LMTLDDLAI	LMTLDDLAI
CLIFLLVLL	CLIFLLVLL
KLTPLCVTL	KLTPLCVTL
YQLAGYILT	YQLAGYILT
FAGKTVWFV	FAGKTVWFV
VLMDGHTGM	VLMDGHTGM
ALAPAPAEV	ALAPAPAEV
TLSGMGYYL	TLSGMGYYL
YLMDEEVPA	YLMDEEVPA
KLLKMVTSV	KLLKMVTSV
MLQDMAILT	MLQDMAILT
FLLPDAQSI	FLLPDAQSI
LLIHFLLSL	LLIHFLLSL
YAMCTNTFV	YAMCTNTFV
MMLVPLITV	MMLVPLITV
LMMILPAAL	LMMILPAAL
GLAMGIMML	GLAMGIMML
YTMADLVYA	YTMADLVYA
LAALFMYYA	LAALFMYYA
WLVHRQWFL	WLVHRQWFL
FIFLLFLTL	FIFLLFLTL
ALSELPETL	ALSELPETL
IVIEAIHTV	IVIEAIHTV
AMAGSIDLL	AMAGSIDLL
KQLELFWVI	KQLELFWVI
YLGEVIVSV	YLGEVIVSV
FMASPENVI	FMASPENVI
CQLAKTCPV	CQLAKTCPV
FIDSNEYEV	FIDSNEYEV
SLFGGMSWI	SLFGGMSWI
VLPFDIKYI	VLPFDIKYI
LIVAALVFL	LIVAALVFL
QIGDIIIAV	QIGDIIIAV
KLFYVYYNL	KLFYVYYNL
KTDGIPITI	KTDGIPITI
ELLEPLYDV	ELLEPLYDV
SMTECSQEL	SMTECSQEL
WLLLRQLPI	WLLLRQLPI
MLSVVGFLV	MLSVVGFLV
KLANPLPYT	KLANPLPYT
YLLMHLVSL	YLLMHLVSL
RLFEESLGI	RLFEESLGI
GLFIYIPGT	GLFIYIPGT
SMWSFNPET	SMWSFNPET
FANNEFTLV	FANNEFTLV
YMDLSYHGV	YMDLSYHGV
ILWDYFSLV	ILWDYFSLV
LLYNGAYHL	LLYNGAYHL
VLYHRYNLV	VLYHRYNLV
MVLAFITFL	MVLAFITFL
KMKKKTWLV	KMKKKTWLV
SIVCIVAAV	SIVCIVAAV
LLFNSLYPA	LLFNSLYPA
AVIDAYTEI	AVIDAYTEI
RLTEDDFGL	RLTEDDFGL
KLKDVLLQV	KLKDVLLQV
FIVVATAAV	FIVVATAAV
TLTRGQNTV	TLTRGQNTV
ILDIAGFEI	ILDIAGFEI
SLVENNFFT	SLVENNFFT
VLFTFVLLL	VLFTFVLLL
ALVAFLRFL	ALVAFLRFL
KVLFLAAFV	KVLFLAAFV
SVVIYDFLV	SVVIYDFLV
NTLMFMVYV	NTLMFMVYV
HVDGKILFV	HVDGKILFV
FLLYILFLV	FLLYILFLV
KLHLYSHPI	KLHLYSHPI
KINIFMAFL	KINIFMAFL
YMWLGARFL	YMWLGARFL
LLHGFSFYL	LLHGFSFYL
WLSLLVPFV	WLSLLVPFV
GLKISLCGI	GLKISLCGI
YLCFLAFLL	YLCFLAFLL
IVALTIMGV	IVALTIMGV
LLIKTLSPA	LLIKTLSPA
LLTEVETYV	LLTEVETYV
SMIEAESSV	SMIEAESSV
RTLLPILLL	RTLLPILLL
LLFLLLADA	LLFLLLADA
SLYNAVVTL	SLYNAVVTL
GLIIISIFL	GLIIISIFL
FLLIRYITT	FLLIRYITT
VLWEGGHDL	VLWEGGHDL
YIDISDVKV	YIDISDVKV
YQDPQNYEL	YQDPQNYEL
ALSPPLLLL	ALSPPLLLL
ITMTTVYHI	ITMTTVYHI
ALGLVCVQA	ALGLVCVQA
VMVKINPTL	VMVKINPTL
SMWALVISV	SMWALVISV
LLAVGATKV	LLAVGATKV
SIKDSMYVI	SIKDSMYVI
GILGTIIFA	GILGTIIFA
YLLADTFTV	YLLADTFTV
MLIKGVDLV	MLIKGVDLV
LLSEIRFYI	LLSEIRFYI
ALPVYLMTL	ALPVYLMTL
FTIAMWLLL	FTIAMWLLL
RLARAIIEL	RLARAIIEL
GLIVGTAFI	GLIVGTAFI
GQWDGWVWL	GQWDGWVWL
FLAFFSNGV	FLAFFSNGV
WMNRLIAFA	WMNRLIAFA
MMKTYIEFV	MMKTYIEFV
ALWIPDLFM	ALWIPDLFM
FAASANFFL	FAASANFFL
WLTSILLSL	WLTSILLSL
LLIDLTSFL	LLIDLTSFL
TIIALLFAL	TIIALLFAL
RTNEEFDPV	RTNEEFDPV
KLLPQLPGV	KLLPQLPGV
FVYTPSPYV	FVYTPSPYV
ALSGVFCGV	ALSGVFCGV
GLVLVWYTV	GLVLVWYTV
TLNFPISPI	TLNFPISPI
LMMMLPATL	LMMMLPATL
ITDQVPFSV	ITDQVPFSV
GLYPLAIPV	GLYPLAIPV
ALAVVNALL	ALAVVNALL
TLGVYDYLV	TLGVYDYLV
VLMMRTTWA	VLMMRTTWA
LLFLKDVEP	LLFLKDVEP
GLCTLVAML	GLCTLVAML
LIVRYLIQV	LIVRYLIQV
YLPKQPEGV	YLPKQPEGV
SLMAFTAAV	SLMAFTAAV
LQDIEITCV	LQDIEITCV
ILFDRLPIA	ILFDRLPIA
LLLWPLYVL	LLLWPLYVL
IVDTVSALV	IVDTVSALV
KLMPICMDV	KLMPICMDV
RMAAWMRQI	RMAAWMRQI
IIMEEGNSI	IIMEEGNSI
TLLCGAATA	TLLCGAATA
TLLCVLAAL	TLLCVLAAL
ALLKHRFEI	ALLKHRFEI
ALNHLVLSL	ALNHLVLSL
FIDTVSVYT	FIDTVSVYT
VLFLQMMNV	VLFLQMMNV
GMRDVSFEL	GMRDVSFEL
GLICGLRQL	GLICGLRQL
FLYDISISL	FLYDISISL
HMMVIFRLM	HMMVIFRLM
YLLEQLNNL	YLLEQLNNL
MAMTGLPQA	MAMTGLPQA
TLVDICFWS	TLVDICFWS
ILCGTCLIV	ILCGTCLIV
NISGYNFSL	NISGYNFSL
MMMGMFNML	MMMGMFNML
FLRGRAYGI	FLRGRAYGI
LVDNVDFAT	LVDNVDFAT
DLTTKNVSI	DLTTKNVSI
KLAGGVAVI	KLAGGVAVI
ALNIALIAV	ALNIALIAV
TVLSFCAFA	TVLSFCAFA
KVEKYLPEV	KVEKYLPEV
SLAADLEKL	SLAADLEKL
LLSLLVIWI	LLSLLVIWI
WLYPGAQNL	WLYPGAQNL
NLVIGFLFL	NLVIGFLFL
SLLYLILFL	SLLYLILFL
LLADGLAKA	LLADGLAKA
IMDASSFTL	IMDASSFTL
LLWSFQTSA	LLWSFQTSA
ATAGWTFGA	ATAGWTFGA
TVIHLEWLL	TVIHLEWLL
LLLCLIFLL	LLLCLIFLL
FIGYMVKNV	FIGYMVKNV
VLYNGVNYL	VLYNGVNYL
LLILSCIFA	LLILSCIFA
FILIFNIIV	FILIFNIIV
KLWTSISCA	KLWTSISCA
FLYNVYPGA	FLYNVYPGA
VILGVLLLI	VILGVLLLI
RLQSLQTYV	RLQSLQTYV
TLLDFAHGL	TLLDFAHGL
MMLAQAYYG	MMLAQAYYG
ALYDVVSTL	ALYDVVSTL
YTFWRLDLV	YTFWRLDLV
IQYRQQLEL	IQYRQQLEL
VLYDEFVTI	VLYDEFVTI
FLHPKHWGT	FLHPKHWGT
QLFHLCLII	QLFHLCLII
VMISILNPV	VMISILNPV
LMSFTILCL	LMSFTILCL
SIISAVVGI	SIISAVVGI
GLAHAAAAV	GLAHAAAAV
LMGHFSWWT	LMGHFSWWT
GLFVSLPVV	GLFVSLPVV
ALAKAAAAM	ALAKAAAAM
YMNYYTTYI	YMNYYTTYI
NIFMTLVPV	NIFMTLVPV
SLDVINYLI	SLDVINYLI
KLLPEGYWV	KLLPEGYWV
LLQLTVWGI	LLQLTVWGI
MMIDDFGTA	MMIDDFGTA
VIHDYICWL	VIHDYICWL
RLMELPVKT	RLMELPVKT
KLITFLFVI	KLITFLFVI
VLLTYFCFV	VLLTYFCFV
FFGWEGVGV	FFGWEGVGV
GSFGDIYLA	GSFGDIYLA
YMSFWCKSI	YMSFWCKSI
YLLGLSAIM	YLLGLSAIM
RQNAPFEPI	RQNAPFEPI
IIMRRFFYF	IIMRRFFYF
TVQEFIFSA	TVQEFIFSA
SVYSWAIML	SVYSWAIML
FAMTVPLLI	FAMTVPLLI
TLLQAAPTL	TLLQAAPTL
FANYNFTLV	FANYNFTLV
LVIGVAFLA	LVIGVAFLA
FMGVLVNSL	FMGVLVNSL
GMGWLTIGI	GMGWLTIGI
SLHCKPEEA	SLHCKPEEA
GLFAEDSPL	GLFAEDSPL
ALMPLYACI	ALMPLYACI
VMAVGLVSI	VMAVGLVSI
RLLPLLALL	RLLPLLALL
RMMGVKYLM	RMMGVKYLM
ILPVIFLSI	ILPVIFLSI
VMAPDKPSL	VMAPDKPSL
NLATSIYTI	NLATSIYTI
RLSPFPALV	RLSPFPALV
KCIDFYSRI	KCIDFYSRI
VMTEGRHAV	VMTEGRHAV
MILAVVITL	MILAVVITL
KLYTIVSTL	KLYTIVSTL
VMLIGIEIL	VMLIGIEIL
FLLPLTSLV	FLLPLTSLV
GLLEAGNSL	GLLEAGNSL
MMMNWSPTT	MMMNWSPTT
KLSNAKWLA	KLSNAKWLA
FMTALVLSL	FMTALVLSL
KTPVIVVPV	KTPVIVVPV
KIDKLTFQI	KIDKLTFQI
YISKCWDYA	YISKCWDYA
VMLLVLCAV	VMLLVLCAV
YLIIGILTL	YLIIGILTL
YVLNSQIAV	YVLNSQIAV
TLLELVVSV	TLLELVVSV
RLFDFNKQA	RLFDFNKQA
FLPKAAYAL	FLPKAAYAL
QLDMIITAV	QLDMIITAV
EQEFLTAAL	EQEFLTAAL
YIIKNTFNV	YIIKNTFNV
GIVCYNEEV	GIVCYNEEV
LIMEFNSLL	LIMEFNSLL
FVNYNFTLV	FVNYNFTLV
MLTNASGHA	MLTNASGHA
RLPLVLPAV	RLPLVLPAV
FLIYLDVSV	FLIYLDVSV
FLIPKGFYA	FLIPKGFYA
RLQEALAVV	RLQEALAVV
SLAGFVRML	SLAGFVRML
YMLDLQPET	YMLDLQPET
SLAGGIIGV	SLAGGIIGV
FLVPFVVFL	FLVPFVVFL
FAIEALAKA	FAIEALAKA
YIFRNTINM	YIFRNTINM
VLCPYMPKV	VLCPYMPKV
KLIIHNPEL	KLIIHNPEL
FLMAPDLYV	FLMAPDLYV
HLREYQDLL	HLREYQDLL
YLYETYHLI	YLYETYHLI
GMANTTFHV	GMANTTFHV
NVFISPASI	NVFISPASI
IILEFFLIV	IILEFFLIV
VLNETTNWL	VLNETTNWL
MQRIISLSV	MQRIISLSV
ILMILIEGI	ILMILIEGI
FTLPVLTFV	FTLPVLTFV
FTAKINEMV	FTAKINEMV
STKNILVTV	STKNILVTV
GLACHQLCA	GLACHQLCA
GLYCYFTHL	GLYCYFTHL
FANYKFTLV	FANYKFTLV
KLSMGLITI	KLSMGLITI
SLFKNVRLL	SLFKNVRLL
CLTSTVQLV	CLTSTVQLV
MLAESCDSV	MLAESCDSV
VVMSWAPPV	VVMSWAPPV
IVYGRSNAI	IVYGRSNAI
YQVAYQATV	YQVAYQATV
FANCNFTLV	FANCNFTLV
FTNSQIFNI	FTNSQIFNI
ATLGTVILL	ATLGTVILL
FLGQADFSL	FLGQADFSL
ACMDGFEVV	ACMDGFEVV
KVAEIVHFL	KVAEIVHFL
KLNVGDYFV	KLNVGDYFV
TIYSHLLLV	TIYSHLLLV
LLDCIMFQS	LLDCIMFQS
NVWATHACV	NVWATHACV
LLPFGQLSI	LLPFGQLSI
ALPHAILRL	ALPHAILRL
TLDAANHSI	TLDAANHSI
FVAPYFESV	FVAPYFESV
TLYCVHQEI	TLYCVHQEI
NLYVSLLLL	NLYVSLLLL
FQFICNLLL	FQFICNLLL
IMFKDDNII	IMFKDDNII
GLPPGTPAV	GLPPGTPAV
FIALWIPDL	FIALWIPDL
GLLDWGMQQ	GLLDWGMQQ
NLNFDQAAL	NLNFDQAAL
FLAVLSPTI	FLAVLSPTI
SLFNTIATL	SLFNTIATL
SQVSFQQPL	SQVSFQQPL
LLDSGTTSI	LLDSGTTSI
AMQAAELPV	AMQAAELPV
ALAKAAAAL	ALAKAAAAL
QLWTTLLSL	QLWTTLLSL
GLYLCVVYV	GLYLCVVYV
VMACLVPAA	VMACLVPAA
GMYYPTNDI	GMYYPTNDI
SLYNTVSTL	SLYNTVSTL
FVDEFYAYL	FVDEFYAYL
FMYIESIKV	FMYIESIKV
GTLGIVCPI	GTLGIVCPI
IVRTNRNEL	IVRTNRNEL
YIFATCLGL	YIFATCLGL
SMHFYGWSL	SMHFYGWSL
AIIGLCAYA	AIIGLCAYA
VLDDGIYRI	VLDDGIYRI
SLVYGIRCV	SLVYGIRCV
FLLTSLRRA	FLLTSLRRA
ALIARCWYL	ALIARCWYL
LIAGIILLI	LIAGIILLI
VNNAVVMPA	VNNAVVMPA
TMLSIILVI	TMLSIILVI
SMVNGVVRL	SMVNGVVRL
SLYKGVYEL	SLYKGVYEL
TMVDKPTEL	TMVDKPTEL
YAIDLPVSV	YAIDLPVSV
LISLINSLV	LISLINSLV
IIITVGMLI	IIITVGMLI
ALWGAFPVL	ALWGAFPVL
LLPGVAHSI	LLPGVAHSI
LVDAIDNIV	LVDAIDNIV
RLDGTTLEV	RLDGTTLEV
ALAWSLQML	ALAWSLQML
DLWNVMYTL	DLWNVMYTL
GLYIPGTSV	GLYIPGTSV
TLYAVATTV	TLYAVATTV
SLNQTVHSL	SLNQTVHSL
SLVNGVVRL	SLVNGVVRL
YFLRRLALV	YFLRRLALV
YQGKTVWFV	YQGKTVWFV
AQIGVIGVF	AQIGVIGVF
IMRVMANNV	IMRVMANNV
FLSNGHVTI	FLSNGHVTI
YLGTALMGA	YLGTALMGA
KVCAITPTI	KVCAITPTI
LLQGVPFHV	LLQGVPFHV
KVTAASPML	KVTAASPML
AMDSNTLEL	AMDSNTLEL
ILDGENCTL	ILDGENCTL
AMFIGHATA	AMFIGHATA
ILWENNIKL	ILWENNIKL
MILALTVAI	MILALTVAI
ILLSIARVV	ILLSIARVV
YLHPKDKYL	YLHPKDKYL
YTDQVPFSV	YTDQVPFSV
CLFPQTLAA	CLFPQTLAA
IILKANFSV	IILKANFSV
YAYGWIPET	YAYGWIPET
LLPAVQCAV	LLPAVQCAV
IMTSYQYLI	IMTSYQYLI
LTFGWCFKL	LTFGWCFKL
HAFLCLFLL	HAFLCLFLL
KIGDKFQTV	KIGDKFQTV
FQTVSFSMV	FQTVSFSMV
TLWAIINTI	TLWAIINTI
KLMPGSIYV	KLMPGSIYV
FMDGKQACV	FMDGKQACV
SLYNLVAVL	SLYNLVAVL
VLYPVIFIT	VLYPVIFIT
YQCGHYTHI	YQCGHYTHI
FLEESHPGI	FLEESHPGI
YIYYFFIRL	YIYYFFIRL
SLIYYQNEV	SLIYYQNEV
FMYTKHSML	FMYTKHSML
VLGDDLLEV	VLGDDLLEV
TIHCFFFAV	TIHCFFFAV
VISVIFYFI	VISVIFYFI
ILAKAIFKL	ILAKAIFKL
WLKGNISPV	WLKGNISPV
ILIEGIFFA	ILIEGIFFA
HLAGFIHAC	HLAGFIHAC
RMQKEITAL	RMQKEITAL
MLWCKDGHV	MLWCKDGHV
GLLTVCYVL	GLLTVCYVL
LLSAGIFGA	LLSAGIFGA
SLSKQDISL	SLSKQDISL
LIIDEIGYL	LIIDEIGYL
ILQDMRNTI	ILQDMRNTI
TLIDIWFLA	TLIDIWFLA
KLFPEVIDL	KLFPEVIDL
AQRWANQIR	AQRWANQIR
FILGIIITV	FILGIIITV
IMSSFEFQV	IMSSFEFQV
RLTGVTSLV	RLTGVTSLV
YLYIMRVMA	YLYIMRVMA
KTWGQYWQV	KTWGQYWQV
FLIDLAFLI	FLIDLAFLI
FVDYNFSLV	FVDYNFSLV
YQYGDNLIL	YQYGDNLIL
TIAVITETI	TIAVITETI
GLIMVLSFL	GLIMVLSFL
YLDGQLARL	YLDGQLARL
YLMPGPVTV	YLMPGPVTV
KIDYYIPYV	KIDYYIPYV
FQQPQFQYL	FQQPQFQYL
ALIRILQQL	ALIRILQQL
AMPGVLSYV	AMPGVLSYV
YLYGLSPAI	YLYGLSPAI
ALTVVWLLV	ALTVVWLLV
CFMYSDFHF	CFMYSDFHF
ALAKAAAAA	ALAKAAAAA
WVIDTLNGI	WVIDTLNGI
GIFCFRILL	GIFCFRILL
YLSSVLLAL	YLSSVLLAL
LLMMTLPSI	LLMMTLPSI
TQWSLFFFV	TQWSLFFFV
VLIQRNPQL	VLIQRNPQL
YQTYTEWSV	YQTYTEWSV
VLFGLGFAI	VLFGLGFAI
YLSDSAINI	YLSDSAINI
VVLSWAPPV	VVLSWAPPV
YLLFNHFSV	YLLFNHFSV
ALMLRLLRI	ALMLRLLRI
NLFTFLHEI	NLFTFLHEI
FGGGPWWEV	FGGGPWWEV
KLLTKPWDV	KLLTKPWDV
QMIYSAARV	QMIYSAARV
LLVQRVTSV	LLVQRVTSV
CLLCNLLLV	CLLCNLLLV
ETDDYMFFV	ETDDYMFFV
YQVKYVSPV	YQVKYVSPV
GLYRQWALA	GLYRQWALA
KMCTVSDYI	KMCTVSDYI
MLWMAEIPL	MLWMAEIPL
FVSCDFTIV	FVSCDFTIV
IILFILFFA	IILFILFFA
GMEAQFLYL	GMEAQFLYL
ALYACVLAA	ALYACVLAA
LMWDNVGLV	LMWDNVGLV
VLAAVLLGA	VLAAVLLGA
SLFSLLPGV	SLFSLLPGV
LLMPILTLT	LLMPILTLT
ALATALTEA	ALATALTEA
MLMFIFTGI	MLMFIFTGI
GLMWLSYFV	GLMWLSYFV
AITLVVISV	AITLVVISV
WILRGTSFV	WILRGTSFV
GLFGGLNWI	GLFGGLNWI
SLSHDFTLV	SLSHDFTLV
KLYCSYEVA	KLYCSYEVA
ALLGAWPAV	ALLGAWPAV
FLFILLLCL	FLFILLLCL
YVFCTVNAL	YVFCTVNAL
LMDCIIFES	LMDCIIFES
QTIDNIVFL	QTIDNIVFL
LMWLSYFVA	LMWLSYFVA
SLYAVSPSV	SLYAVSPSV
SLFDCIVPV	SLFDCIVPV
SLSSIRFHI	SLSSIRFHI
ALMAITKNV	ALMAITKNV
YLVSSLSEI	YLVSSLSEI
SLIAIIKGV	SLIAIIKGV
MVAKYDLLV	MVAKYDLLV
FLGRYMSAL	FLGRYMSAL
ILLEPVHGV	ILLEPVHGV
LLMRTSWAL	LLMRTSWAL
AMLQDMAIL	AMLQDMAIL
AIIDYIAYM	AIIDYIAYM
RMWAWIHGL	RMWAWIHGL
RVYAHVRSV	RVYAHVRSV
IILLFDFSI	IILLFDFSI
RVACRDVEV	RVACRDVEV
KMAQCTLAV	KMAQCTLAV
GLPMNTGWV	GLPMNTGWV
NLDLFMSHV	NLDLFMSHV
SLARGFPFV	SLARGFPFV
ATYGIIVPV	ATYGIIVPV
LLFGYPVYV	LLFGYPVYV
AQFLYLYAL	AQFLYLYAL
GLDVKNVQL	GLDVKNVQL
YLANGGFLI	YLANGGFLI
TLLCLIPTA	TLLCLIPTA
GLSCLLAAL	GLSCLLAAL
QLFSFFEEV	QLFSFFEEV
SLLDEDSKI	SLLDEDSKI
FLTSVINRV	FLTSVINRV
IIWGELFGV	IIWGELFGV
YLVSFGVWI	YLVSFGVWI
FLHYCNSYA	FLHYCNSYA
GMLSSLHTL	GMLSSLHTL
YIVGANIET	YIVGANIET
RMGAVTTEV	RMGAVTTEV
IVYCLNALV	IVYCLNALV
FLWGPRALI	FLWGPRALI
SLDDYNHLV	SLDDYNHLV
KIWMAPSLT	KIWMAPSLT
WVWDTWPLA	WVWDTWPLA
YLYLTFYFT	YLYLTFYFT
FAFKDLFVV	FAFKDLFVV
FITTMAPRV	FITTMAPRV
FLVGQLFTF	FLVGQLFTF
LTDHPLFPV	LTDHPLFPV
KLWGLVDFV	KLWGLVDFV
YLMAWKQVL	YLMAWKQVL
FLSDSEAEA	FLSDSEAEA
LLLEVEQEI	LLLEVEQEI
SLNLRETNL	SLNLRETNL
FLRYLLFGI	FLRYLLFGI
FTILEYLYI	FTILEYLYI
KLGGYVSFV	KLGGYVSFV
QIMECSRML	QIMECSRML
YLGPRVCWL	YLGPRVCWL
KMVELVHFL	KMVELVHFL
SLYNTITVL	SLYNTITVL
FLSRLVLYA	FLSRLVLYA
LLQFIVFLL	LLQFIVFLL
YFHALVYFV	YFHALVYFV
KVIKLVKSL	KVIKLVKSL
MVISLLSMI	MVISLLSMI
GLIYTYSGL	GLIYTYSGL
IVAALVFLI	IVAALVFLI
FICWHSSEI	FICWHSSEI
YLSAKITTL	YLSAKITTL
ALKEAIEMV	ALKEAIEMV
MMAKEEELV	MMAKEEELV
ALFGYPVYV	ALFGYPVYV
RILQQLLFI	RILQQLLFI
SLYNVVATL	SLYNVVATL
LLAENLPGL	LLAENLPGL
KLQDCTMLV	KLQDCTMLV
YLMDKLNLT	YLMDKLNLT
FLCPTFTLK	FLCPTFTLK
SLFNTVVTL	SLFNTVVTL
IMEYHLLFA	IMEYHLLFA
FVFAWFNGV	FVFAWFNGV
LLDEYRDYI	LLDEYRDYI
ILMQVPFSV	ILMQVPFSV
LIWTLDANI	LIWTLDANI
RLPRYLACL	RLPRYLACL
VLIALSVLA	VLIALSVLA
KLSMGLIAI	KLSMGLIAI
LVFIKPPLI	LVFIKPPLI
AIIPLSASV	AIIPLSASV
YVVAYQATV	YVVAYQATV
FIDSYICQV	FIDSYICQV
SLIKSTLQV	SLIKSTLQV
YLLAVCGCI	YLLAVCGCI
SIFVSTMPV	SIFVSTMPV
FQWSDDPFI	FQWSDDPFI
LLNESNIFL	LLNESNIFL
MMVILPDKI	MMVILPDKI
YLLDRGADI	YLLDRGADI
YINMAWNLV	YINMAWNLV
ALGDLFQSI	ALGDLFQSI
RLFTRCAVI	RLFTRCAVI
VLTHGLASV	VLTHGLASV
ILHRLAPWI	ILHRLAPWI
KLPTWLGAA	KLPTWLGAA
EMPPHIYAI	EMPPHIYAI
RLITVNPIV	RLITVNPIV
GLADQLIHL	GLADQLIHL
LVASLNPNM	LVASLNPNM
KLADMSIYC	KLADMSIYC
ILFVVIVGL	ILFVVIVGL
FLAVGGVLL	FLAVGGVLL
FLVPGTHVA	FLVPGTHVA
FLARLIWWL	FLARLIWWL
SLFLPKLVV	SLFLPKLVV
RMYSPISIL	RMYSPISIL
YLVTRNADV	YLVTRNADV
KLMDVVYSI	KLMDVVYSI
GLLRVISGV	GLLRVISGV
KIMEIVSHL	KIMEIVSHL
GLWLSVAAV	GLWLSVAAV
FVFILTAIL	FVFILTAIL
ALVAWLTHA	ALVAWLTHA
AIMESDSFL	AIMESDSFL
CINGACWTV	CINGACWTV
KMVGTVQRV	KMVGTVQRV
SLFNTVATL	SLFNTVATL
SLTAISTTL	SLTAISTTL
FLYGALALA	FLYGALALA
LMTAISQGI	LMTAISQGI
LLLDYMTST	LLLDYMTST
RQVSVKLLI	RQVSVKLLI
SLSTYTVPI	SLSTYTVPI
DINVIGLIV	DINVIGLIV
HIFYQLANV	HIFYQLANV
VLHDDLCEA	VLHDDLCEA
GVNACQVGV	GVNACQVGV
YVGDTSMMV	YVGDTSMMV
VLNIVLFIL	VLNIVLFIL
RMLGDVMAV	RMLGDVMAV
FLARSALIL	FLARSALIL
VLLNAPSEA	VLLNAPSEA
ATQPVHWFL	ATQPVHWFL
VMMSCSSEA	VMMSCSSEA
KLPQLCTEL	KLPQLCTEL
SQMGLSCAL	SQMGLSCAL
TIWAANAGV	TIWAANAGV
MLIDLGLDL	MLIDLGLDL
ILLAPLLSA	ILLAPLLSA
LLDLFGPEV	LLDLFGPEV
FHFNPLPNV	FHFNPLPNV
KLFIRQEEV	KLFIRQEEV
RLNDFLGLL	RLNDFLGLL
LMWITQCFL	LMWITQCFL
IPDGWWWAI	IPDGWWWAI
VLSDFRTWL	VLSDFRTWL
VLSIMAFIL	VLSIMAFIL
SLFNWLWYE	SLFNWLWYE
GLSDRVVFV	GLSDRVVFV
FLLNKEMYL	FLLNKEMYL
FVFLVLAGR	FVFLVLAGR
LLSLFSTLV	LLSLFSTLV
FIHGGILYA	FIHGGILYA
YLKEYIPKA	YLKEYIPKA
YVLLHLLVV	YVLLHLLVV
TMYYKDVTV	TMYYKDVTV
FVAEGDALV	FVAEGDALV
RLWHYPCTV	RLWHYPCTV
YLVSIFLHL	YLVSIFLHL
VLVDNVDFA	VLVDNVDFA
SLLADVQQL	SLLADVQQL
FTMGVLCLA	FTMGVLCLA
YLYPGPVTV	YLYPGPVTV
MLDTWNEDL	MLDTWNEDL
YLYPWSLGL	YLYPWSLGL
FANDKFTLV	FANDKFTLV
SISGVLWQV	SISGVLWQV
YNLSLSAAV	YNLSLSAAV
LTIVFVPEV	LTIVFVPEV
GLVDEQQEV	GLVDEQQEV
FTDQVPFSV	FTDQVPFSV
RVIGLCIRI	RVIGLCIRI
GMDPRMCSL	GMDPRMCSL
KLQAAPYIV	KLQAAPYIV
CMSANEAAI	CMSANEAAI
MQDVFTFYV	MQDVFTFYV
YLTLGGHTV	YLTLGGHTV
LLQEYNWEL	LLQEYNWEL
LMHATYFLA	LMHATYFLA
IMYTYFSNT	IMYTYFSNT
GLTSAVIDA	GLTSAVIDA
LLANGNVYA	LLANGNVYA
ALWDVPSPA	ALWDVPSPA
QLFKYVPSA	QLFKYVPSA
VLIRRCHYL	VLIRRCHYL
IMNEGWASF	IMNEGWASF
GLVRLNAFL	GLVRLNAFL
FLLSGTAIA	FLLSGTAIA
LLGTFTWTL	LLGTFTWTL
GLMTAVYLV	GLMTAVYLV
GLIACLIFV	GLIACLIFV
RLIGHISTL	RLIGHISTL
SLFDVGKFT	SLFDVGKFT
LLDDFVEII	LLDDFVEII
GLAVDLYAL	GLAVDLYAL
SLRNVLAAV	SLRNVLAAV
IMAAILAYT	IMAAILAYT
NTSWNDTVT	NTSWNDTVT
GMFANRWII	GMFANRWII
QLFNHTMFI	QLFNHTMFI
FANSKFTLV	FANSKFTLV
FLYGALLAA	FLYGALLAA
FLNRFTTTL	FLNRFTTTL
FMTSSWWRA	FMTSSWWRA
SVMNFIPII	SVMNFIPII
FLNGSCGSV	FLNGSCGSV
CVMYASALV	CVMYASALV
AIHNVVHAI	AIHNVVHAI
MLLALIAVL	MLLALIAVL
IMFMLIFNV	IMFMLIFNV
WLLPLWAAL	WLLPLWAAL
ALVSEVTEV	ALVSEVTEV
YLLCCNYKL	YLLCCNYKL
WLLCKLSCA	WLLCKLSCA
KILSVFFLA	KILSVFFLA
IIDQVPFSV	IIDQVPFSV
VQYRILPMI	VQYRILPMI
LIMIYFFII	LIMIYFFII
VTDYVHEGV	VTDYVHEGV
FLDLPLPWA	FLDLPLPWA
LLFGAPVYV	LLFGAPVYV
RLNKVISEL	RLNKVISEL
NLPIYSEEI	NLPIYSEEI
KTWFLVPLI	KTWFLVPLI
NMLSTVLGV	NMLSTVLGV
MVNTVLITV	MVNTVLITV
FLIYFRSPL	FLIYFRSPL
YLSTERDHV	YLSTERDHV
VLLFLAFVV	VLLFLAFVV
YNIDRLNAL	YNIDRLNAL
LLLMGCDIV	LLLMGCDIV
LLLLVAHYA	LLLLVAHYA
KLWAQCVQL	KLWAQCVQL
ITMQVPFSV	ITMQVPFSV
LLWDYMCIS	LLWDYMCIS
SLNSMYTRL	SLNSMYTRL
FILDNPGFV	FILDNPGFV
LMSTLLIYL	LMSTLLIYL
KMMGRLADA	KMMGRLADA
GLWAIKSVL	GLWAIKSVL
LLTACTIFY	LLTACTIFY
VMWKCLIRL	VMWKCLIRL
HLMRDPALL	HLMRDPALL
LMMRTTWAL	LMMRTTWAL
KLTFLDVEV	KLTFLDVEV
SLPSYAAYA	SLPSYAAYA
SLNARGLLV	SLNARGLLV
GLHCDFACL	GLHCDFACL
RALKAYFTA	RALKAYFTA
YIVGYYSAL	YIVGYYSAL
VLDEVMSTL	VLDEVMSTL
KLTDWDFVV	KLTDWDFVV
ILMTHFFSI	ILMTHFFSI
GLGRHLWRL	GLGRHLWRL
KMEDSVGCL	KMEDSVGCL
TLLGCWSFV	TLLGCWSFV
KLQWLFAAL	KLQWLFAAL
ALAVFQPAV	ALAVFQPAV
ALMGAVTSL	ALMGAVTSL
GLGPTLMCL	GLGPTLMCL
ALGERLDAV	ALGERLDAV
WYYDFHFFV	WYYDFHFFV
YSLEYFQFV	YSLEYFQFV
NLFEKFFPS	NLFEKFFPS
HLCRYVALL	HLCRYVALL
GLLDRLYDL	GLLDRLYDL
VLRDDLLEA	VLRDDLLEA
VLSEWLPVT	VLSEWLPVT
FVARVFLGL	FVARVFLGL
SLLDSLLVM	SLLDSLLVM
SLLEIGEGV	SLLEIGEGV
TMHSLTIQM	TMHSLTIQM
YIYTRSFQM	YIYTRSFQM
RLLEVMDSL	RLLEVMDSL
ITFQVPFSV	ITFQVPFSV
FTPQFLLQL	FTPQFLLQL
FLFELIPEP	FLFELIPEP
LMDMITLSL	LMDMITLSL
RLLQETELV	RLLQETELV
YLCPVLVFV	YLCPVLVFV
NIAEYIAGL	NIAEYIAGL
RLPPHTQPV	RLPPHTQPV
LLDSHYESV	LLDSHYESV
TLLGLILFV	TLLGLILFV
IMDEPTSSL	IMDEPTSSL
KLGIGNSPV	KLGIGNSPV
CMIRWLGGI	CMIRWLGGI
IVYLCPVLV	IVYLCPVLV
ALNIALVAV	ALNIALVAV
VPRPCQKSL	VPRPCQKSL
ALGMRGLVL	ALGMRGLVL
NMQTVKLFV	NMQTVKLFV
YVVWLMFSL	YVVWLMFSL
YIVAYQATV	YIVAYQATV
FIKPPLITL	FIKPPLITL
FLRFGDFKL	FLRFGDFKL
KLADYLNVL	KLADYLNVL
QLAGYILTV	QLAGYILTV
NCLSLLLSV	NCLSLLLSV
AMKADIQHV	AMKADIQHV
SLDSWWTSV	SLDSWWTSV
AMLNGLIYV	AMLNGLIYV
FVDYNFTIV	FVDYNFTIV
LLFDSNEPI	LLFDSNEPI
KIADDRIVV	KIADDRIVV
ALWYFFPVL	ALWYFFPVL
DLERKVESL	DLERKVESL
YTYSGLFCV	YTYSGLFCV
NVGRILGYV	NVGRILGYV
SIVAYTMSL	SIVAYTMSL
MLCLLLLSV	MLCLLLLSV
ILWQVPFSV	ILWQVPFSV
YVDIIGLSV	YVDIIGLSV
ALSEGVYRI	ALSEGVYRI
ALFSGVSWV	ALFSGVSWV
GLLLLCVGV	GLLLLCVGV
KQWGWFALL	KQWGWFALL
WLKDSAIMV	WLKDSAIMV
SIYHTGVEL	SIYHTGVEL
SMNATLVQA	SMNATLVQA
FLTDYIPGA	FLTDYIPGA
CVLTTIDGV	CVLTTIDGV
SMLGIWFFT	SMLGIWFFT
KLLWAVEPL	KLLWAVEPL
AISYCRAFI	AISYCRAFI
NTVATLYCV	NTVATLYCV
SQYYFSMLV	SQYYFSMLV
TLIQYRQQL	TLIQYRQQL
FSWTITDAV	FSWTITDAV
GLAGLQTDV	GLAGLQTDV
FLATCVNGV	FLATCVNGV
LMPSPPMPV	LMPSPPMPV
VLAALVCYI	VLAALVCYI
LLDPLYFEV	LLDPLYFEV
KLLSTSNVI	KLLSTSNVI
MTFGDIPLV	MTFGDIPLV
ALMAGYFKI	ALMAGYFKI
LLPSLFLLL	LLPSLFLLL
FTLLFQLCT	FTLLFQLCT
HLTENNLYI	HLTENNLYI
YIIRVTTEL	YIIRVTTEL
YVSSIFLHL	YVSSIFLHL
CINGVCWTV	CINGVCWTV
YVASYLLAA	YVASYLLAA
YVNHTGFNV	YVNHTGFNV
LMVDSFDPV	LMVDSFDPV
VLGAAIWWV	VLGAAIWWV
KLTEEIIKL	KLTEEIIKL
SIMAFILGI	SIMAFILGI
IMDQVPFSV	IMDQVPFSV
ALYYVHSLL	ALYYVHSLL
QLVDAIDNI	QLVDAIDNI
FMNEDHWFS	FMNEDHWFS
SVFRENLFL	SVFRENLFL
MALLRLPLV	MALLRLPLV
FLHNYILYA	FLHNYILYA
YLHRDIFDI	YLHRDIFDI
KLAVYYYII	KLAVYYYII
RLNNRPIAV	RLNNRPIAV
FVLAAVYRI	FVLAAVYRI
IISDLSIFI	IISDLSIFI
VLTSVDIET	VLTSVDIET
MVWESGCTV	MVWESGCTV
YIGEVLVSV	YIGEVLVSV
QLVWENFLA	QLVWENFLA
WMMLLIAQA	WMMLLIAQA
SAWESFWRI	SAWESFWRI
AQPGLLSYV	AQPGLLSYV
RVMVSPLAV	RVMVSPLAV
ALMDKVLKV	ALMDKVLKV
GLLEWIFRA	GLLEWIFRA
YTQDELINV	YTQDELINV
WTLETLPRV	WTLETLPRV
MQVFFGYFA	MQVFFGYFA
ALMRRIAVV	ALMRRIAVV
MLGEETIKV	MLGEETIKV
MVNHSTYYV	MVNHSTYYV
TLAQSLIDV	TLAQSLIDV
LLFEVEQEI	LLFEVEQEI
FANHKFTLV	FANHKFTLV
FLLFLVLIM	FLLFLVLIM
VLMTHFFSV	VLMTHFFSV
STSFYLISI	STSFYLISI
ILYNEYNFV	ILYNEYNFV
LMLPGMNGI	LMLPGMNGI
YLVKYQATV	YLVKYQATV
ALFSGVSWI	ALFSGVSWI
MLLHVGIPL	MLLHVGIPL
YLWPGPVTA	YLWPGPVTA
FLEQGGFKA	FLEQGGFKA
SVGGVFTSV	SVGGVFTSV
YLARAAGLV	YLARAAGLV
QLNDYEQLL	QLNDYEQLL
LLGQVQTYV	LLGQVQTYV
DLYDMIHNV	DLYDMIHNV
KLDYWSFQL	KLDYWSFQL
MIYDLNAVT	MIYDLNAVT
QLDKCSAFV	QLDKCSAFV
HMWNFISGI	HMWNFISGI
ALSPVLPPM	ALSPVLPPM
FKNSSNLFT	FKNSSNLFT
AVWISLAQV	AVWISLAQV
HLSPALADV	HLSPALADV
RAMACSALI	RAMACSALI
MMLRDRWSL	MMLRDRWSL
LTFWQIDYL	LTFWQIDYL
TMPELAWAV	TMPELAWAV
SLWKDGAPL	SLWKDGAPL
ITDWLNFTL	ITDWLNFTL
FLCKQYLNL	FLCKQYLNL
RMFGMPTAL	RMFGMPTAL
LLYDGSFAV	LLYDGSFAV
ILVVSLLLV	ILVVSLLLV
YQYVRLHEM	YQYVRLHEM
LTFNFTPKI	LTFNFTPKI
ITATFTAPL	ITATFTAPL
YVFTLLFQL	YVFTLLFQL
RMMETWHPL	RMMETWHPL
MIFVSSIFI	MIFVSSIFI
FMKVKFEAL	FMKVKFEAL
GLFQLIFFL	GLFQLIFFL
VLLPSLFLL	VLLPSLFLL
ILISLINSL	ILISLINSL
VLHDDLLEA	VLHDDLLEA
YLSEEMMEL	YLSEEMMEL
CMWGRLWQL	CMWGRLWQL
ELVRYIELV	ELVRYIELV
KLITQPLPA	KLITQPLPA
NLFDWMHFL	NLFDWMHFL
ALTNAQFFV	ALTNAQFFV
VLAEAMSQV	VLAEAMSQV
GLLASAPGI	GLLASAPGI
TLLRLACEV	TLLRLACEV
SISGVLWTV	SISGVLWTV
MLLMLLPTA	MLLMLLPTA
YLTAIQDFI	YLTAIQDFI
VISKIYTLI	VISKIYTLI
YVITTQHWL	YVITTQHWL
HTICDDYFV	HTICDDYFV
SLIAIIKGI	SLIAIIKGI
WIIKNSWTA	WIIKNSWTA
KLQERLAKL	KLQERLAKL
YLRGHTESI	YLRGHTESI
NLDDVYSYI	NLDDVYSYI
KMDLGVPLL	KMDLGVPLL
KLYLVDYGL	KLYLVDYGL
TLLCVLPAV	TLLCVLPAV
KLVSISNFI	KLVSISNFI
VLFDDLCEA	VLFDDLCEA
FLPGQYMNI	FLPGQYMNI
SILGCDVSV	SILGCDVSV
VLAKDGTEV	VLAKDGTEV
YLNKIQNSL	YLNKIQNSL
WVLAYMLFT	WVLAYMLFT
FLVIAINAM	FLVIAINAM
YLKEACNHA	YLKEACNHA
ILAQVPFSV	ILAQVPFSV
YKDANISMY	YKDANISMY
ALIHHNTYL	ALIHHNTYL
YLGEVLVSV	YLGEVLVSV
ILGLPTQTV	ILGLPTQTV
AILHNIYRL	AILHNIYRL
YILGFAIPI	YILGFAIPI
FLGMESCGI	FLGMESCGI
ILFTFLHLA	ILFTFLHLA
ALREEEEGV	ALREEEEGV
LLAVAVYAV	LLAVAVYAV
FLDDASNSA	FLDDASNSA
VMPEKRNVV	VMPEKRNVV
TVLRFVPPL	TVLRFVPPL
NMNNDSYYF	NMNNDSYYF
LMAEDLANV	LMAEDLANV
MIYGLIACL	MIYGLIACL
ILKDFSILL	ILKDFSILL
MSDWGHITV	MSDWGHITV
FLLRWEQEI	FLLRWEQEI
YLIPFIWFV	YLIPFIWFV
YLDYDTIYV	YLDYDTIYV
GLTADARLL	GLTADARLL
LLTYLEYPI	LLTYLEYPI
LLVEVLREI	LLVEVLREI
YLDLALMSV	YLDLALMSV
FTINIAAYL	FTINIAAYL
FLLVTLAIL	FLLVTLAIL
HFIGYIYEV	HFIGYIYEV
YLHIHPFKI	YLHIHPFKI
KLLNMRDLI	KLLNMRDLI
YLVAYQKTV	YLVAYQKTV
TLKPGTMSV	TLKPGTMSV
RLLDDTPEV	RLLDDTPEV
SVLLFLAFV	SVLLFLAFV
ALLTGSYTI	ALLTGSYTI
VIIAALVLV	VIIAALVLV
FMTSSWWGA	FMTSSWWGA
NLWNGIVPT	NLWNGIVPT
YFVAYQATV	YFVAYQATV
FLLQLNETI	FLLQLNETI
FLLAQFTSA	FLLAQFTSA
MQDGRFDGI	MQDGRFDGI
GVFIQVYEV	GVFIQVYEV
SLTPSPLDL	SLTPSPLDL
GLYLSQIAV	GLYLSQIAV
SMYVIPDEL	SMYVIPDEL
LIDNPDNNL	LIDNPDNNL
NLLLWPLYV	NLLLWPLYV
SMVKLPIFL	SMVKLPIFL
FMLPKQDIV	FMLPKQDIV
AMHARMAAV	AMHARMAAV
KVLSIMAFI	KVLSIMAFI
MLEEMQSAV	MLEEMQSAV
FLISVIVLV	FLISVIVLV
FLEPGPVTA	FLEPGPVTA
CLINDPWVL	CLINDPWVL
KLIDRTESL	KLIDRTESL
ILTLANWCL	ILTLANWCL
YLSGANLNV	YLSGANLNV
HLDDVGFLV	HLDDVGFLV
YLREYVTRL	YLREYVTRL
KMFNSVGGA	KMFNSVGGA
GIRPYEILA	GIRPYEILA
MTYAAPLFV	MTYAAPLFV
ALVSDCAST	ALVSDCAST
FLSFASLFL	FLSFASLFL
SLTDRELLL	SLTDRELLL
GLVDLFVFS	GLVDLFVFS
LLLWISVKV	LLLWISVKV
ALLAGLVSL	ALLAGLVSL
NQNDNEETV	NQNDNEETV
KQLAAVARV	KQLAAVARV
GLYGAQYDV	GLYGAQYDV
KQYGDIDLL	KQYGDIDLL
VQYRGLYQI	VQYRGLYQI
CISQHQHLA	CISQHQHLA
SLHNAVAVL	SLHNAVAVL
HIMPNSFRV	HIMPNSFRV
IMAVGLVSL	IMAVGLVSL
GLCNYGGIL	GLCNYGGIL
SLFNAVVTL	SLFNAVVTL
YQLGDYFFV	YQLGDYFFV
NLAEDIMRL	NLAEDIMRL
QMISPVMSV	QMISPVMSV
FLAAECPFL	FLAAECPFL
YTALHYYYL	YTALHYYYL
ALNSKDAAL	ALNSKDAAL
KQYLNLYPV	KQYLNLYPV
MLLNVQTLI	MLLNVQTLI
FLALVSNRV	FLALVSNRV
GIPPAPHGV	GIPPAPHGV
VLETAVGLL	VLETAVGLL
ATISYRIKL	ATISYRIKL
FLTCTDRSV	FLTCTDRSV
TLRGLFFSV	TLRGLFFSV
LLSMITMSA	LLSMITMSA
WTMKILIGV	WTMKILIGV
SLVKHHMYV	SLVKHHMYV
LLNNSLGSV	LLNNSLGSV
LLACAVIHA	LLACAVIHA
GLFQPFMFV	GLFQPFMFV
YLYALYSPL	YLYALYSPL
ISDPLTSGL	ISDPLTSGL
RLVDAMVYT	RLVDAMVYT
KTSTLIFFV	KTSTLIFFV
VILPACAFV	VILPACAFV
VICSFLVFL	VICSFLVFL
ILTLDIFYL	ILTLDIFYL
HVAAFSSLI	HVAAFSSLI
KSFFWFNEV	KSFFWFNEV
KMIGNHLWV	KMIGNHLWV
FMRSISDDA	FMRSISDDA
YTAFTIPSI	YTAFTIPSI
SLEATFIDV	SLEATFIDV
VLSEYETMV	VLSEYETMV
ITAALAWSL	ITAALAWSL
LILSLTCSV	LILSLTCSV
LVWYTVFGA	LVWYTVFGA
LLDTGPFSA	LLDTGPFSA
VLMLVAHYA	VLMLVAHYA
SLVENALVV	SLVENALVV
NMISDTIFV	NMISDTIFV
SLADTNSLA	SLADTNSLA
FMHIWLQAA	FMHIWLQAA
CMLDGGNML	CMLDGGNML
ALLPAPITL	ALLPAPITL
VMKLFTISV	VMKLFTISV
ILYSVLQHL	ILYSVLQHL
ILNPYMPSV	ILNPYMPSV
VILAGPIPV	VILAGPIPV
SLYNTIATL	SLYNTIATL
SLYNTVAAL	SLYNTVAAL
KVAELVWFL	KVAELVWFL
KMQQNIQEL	KMQQNIQEL
AIAKAAAAV	AIAKAAAAV
MAFDISVNA	MAFDISVNA
FLYNRPLSV	FLYNRPLSV
YMIMVKCWM	YMIMVKCWM
AISAVYFKA	AISAVYFKA
GVYGGLCLA	GVYGGLCLA
TMDPSVRVL	TMDPSVRVL
FIAEIDHWI	FIAEIDHWI
LLCVLPAVV	LLCVLPAVV
YIYNHLTPL	YIYNHLTPL
GVYDYLVST	GVYDYLVST
ILDSVGIEA	ILDSVGIEA
YLCSLAVVL	YLCSLAVVL
YYFSYPLFV	YYFSYPLFV
YLYVHSPAL	YLYVHSPAL
FLFMDRDAL	FLFMDRDAL
FVFSTSFYL	FVFSTSFYL
VLSPTIGHV	VLSPTIGHV
NLAQDLATV	NLAQDLATV
LLVLCVTQV	LLVLCVTQV
SLMAFTASV	SLMAFTASV
YQIEGAWRA	YQIEGAWRA
ALYSYASAK	ALYSYASAK
KLLALLGQV	KLLALLGQV
SMMSFSAAL	SMMSFSAAL
IAPNASLGV	IAPNASLGV
FLKNRFEAL	FLKNRFEAL
VLQQSTYQL	VLQQSTYQL
ILLLCLIFL	ILLLCLIFL
FLNPVIYTF	FLNPVIYTF
WLGNHGFEV	WLGNHGFEV
LLFILFYFA	LLFILFYFA
FIYGYLEPV	FIYGYLEPV
TLLMNELGV	TLLMNELGV
HLECRTFFL	HLECRTFFL
ATLNTLITL	ATLNTLITL
RVIEVLQRA	RVIEVLQRA
FQGRGVFEL	FQGRGVFEL
IMAVGIVSI	IMAVGIVSI
FLSHKIHVI	FLSHKIHVI
MQYEVTQHA	MQYEVTQHA
SIFGFQAEV	SIFGFQAEV
LLTDTIESA	LLTDTIESA
LMDALKLSI	LMDALKLSI
QLLADFPEA	QLLADFPEA
YVHGDTYSL	YVHGDTYSL
ITMGMPYAV	ITMGMPYAV
VILAGPMPV	VILAGPMPV
LMWFIISIV	LMWFIISIV
FLTSLLILV	FLTSLLILV
GLISFYNFL	GLISFYNFL
TVADIWHAM	TVADIWHAM
GLAVVLWSL	GLAVVLWSL
KQLESVMYL	KQLESVMYL
GLWVCATSL	GLWVCATSL
YTYAFTKKV	YTYAFTKKV
SVLLWMASV	SVLLWMASV
RQISQDVKL	RQISQDVKL
VMSELEFYL	VMSELEFYL
FLFAFLSAA	FLFAFLSAA
RLPLYEALV	RLPLYEALV
SIFERIREA	SIFERIREA
FLGTSISGV	FLGTSISGV
YMAKLHAYL	YMAKLHAYL
FVADYLARF	FVADYLARF
ILEDQNCKL	ILEDQNCKL
ALWMRLLPL	ALWMRLLPL
VTLLCVLPA	VTLLCVLPA
WLMKNMDPL	WLMKNMDPL
QLWATLLSL	QLWATLLSL
VLLVSLGAI	VLLVSLGAI
HMTEVVRHC	HMTEVVRHC
FLADAVVRL	FLADAVVRL
MLMEVFPQL	MLMEVFPQL
DLKPDNILL	DLKPDNILL
ILWGYGFLQ	ILWGYGFLQ
ITWQVPFSV	ITWQVPFSV
VLDRRLHLV	VLDRRLHLV
FLLALLSCI	FLLALLSCI
FMYEGDTPL	FMYEGDTPL
RLIDFLKDV	RLIDFLKDV
ILLSCIHTT	ILLSCIHTT
KLFPRLPGI	KLFPRLPGI
WLGHPFTPV	WLGHPFTPV
NLIDWFNQT	NLIDWFNQT
FVGVIILGV	FVGVIILGV
ILFLWSFLV	ILFLWSFLV
ILHNGAYSL	ILHNGAYSL
KQWSWFSLL	KQWSWFSLL
QIIGYVIGT	QIIGYVIGT
FIYLLFASM	FIYLLFASM
YMQQVSEGL	YMQQVSEGL
SEHFSLLFL	SEHFSLLFL
LWMRLLPLL	LWMRLLPLL
YMLSWGKEA	YMLSWGKEA
FLAASALGV	FLAASALGV
NMLRIMASL	NMLRIMASL
VLPATFAAV	VLPATFAAV
MTSELAALI	MTSELAALI
RLPRIFCSC	RLPRIFCSC
YLDPAQQNL	YLDPAQQNL
FLWSVFMLI	FLWSVFMLI
VLWTVFHGA	VLWTVFHGA
IMMGVLVGV	IMMGVLVGV
AQSDFMSWV	AQSDFMSWV
GLYYLTTEV	GLYYLTTEV
ILSNKLLYA	ILSNKLLYA
WLIGFDFDV	WLIGFDFDV
FLSSSALAV	FLSSSALAV
CLWPKTHTL	CLWPKTHTL
MINKLYGYA	MINKLYGYA
KLFGFGAQF	KLFGFGAQF
YVLHFACLV	YVLHFACLV
LLFKTSVGV	LLFKTSVGV
ALWGFFPVL	ALWGFFPVL
VVCNDLYKV	VVCNDLYKV
ALLGLTLGV	ALLGLTLGV
FLITGVFDI	FLITGVFDI
HLDFWHHEV	HLDFWHHEV
GIYGAVIPL	GIYGAVIPL
KQLEWKWGI	KQLEWKWGI
ILLENLMRA	ILLENLMRA
AMLAAIRRV	AMLAAIRRV
KLWASFFQG	KLWASFFQG
LLATSIFKL	LLATSIFKL
KIMSIGFEA	KIMSIGFEA
LLMRTTWAL	LLMRTTWAL
SLYNKVATL	SLYNKVATL
MINDTHFLL	MINDTHFLL
IVWEKKSLV	IVWEKKSLV
GLDSYVRSL	GLDSYVRSL
WLYDLWGQL	WLYDLWGQL
DLGPAFTEL	DLGPAFTEL
AMNREVSSL	AMNREVSSL
GLSQFTQTV	GLSQFTQTV
ALAGFFPVL	ALAGFFPVL
ALCEALTLA	ALCEALTLA
FLYDRIAST	FLYDRIAST
GLIHACMLV	GLIHACMLV
GIALAVPCV	GIALAVPCV
VLEKGIPTL	VLEKGIPTL
KLMNIQQKL	KLMNIQQKL
VLTILYYGA	VLTILYYGA
FLYPSWSLY	FLYPSWSLY
RLFDFFSRV	RLFDFFSRV
ALLRMCALV	ALLRMCALV
IYDFYNAEY	IYDFYNAEY
ALMDLLMFS	ALMDLLMFS
CLMTYSHHA	CLMTYSHHA
RLAELIGPA	RLAELIGPA
CLTEYILWV	CLTEYILWV
GMVIACLLV	GMVIACLLV
VLALYSPPL	VLALYSPPL
VVTAIVYVV	VVTAIVYVV
LLGTWMFSV	LLGTWMFSV
IILAISALL	IILAISALL
LLAMTFWPA	LLAMTFWPA
RLFSYNFTT	RLFSYNFTT
YVIKVSARV	YVIKVSARV
FADSDGHYV	FADSDGHYV
ALAPVFAFL	ALAPVFAFL
NLAPHLLLI	NLAPHLLLI
SLYAVTTAV	SLYAVTTAV
FQWWRSHPL	FQWWRSHPL
FMSVVNTNI	FMSVVNTNI
ALGLSAFGV	ALGLSAFGV
KLFCQLAKV	KLFCQLAKV
AIYHPQQFV	AIYHPQQFV
WLLWPVTLA	WLLWPVTLA
KQLNYCHLI	KQLNYCHLI
LLSSNLSWL	LLSSNLSWL
KMIKNLTQL	KMIKNLTQL
YLVWQPMSA	YLVWQPMSA
ATNIFPFFV	ATNIFPFFV
IIFILLMLV	IIFILLMLV
NLGNLNVSI	NLGNLNVSI
TVLEKNVTV	TVLEKNVTV
RTFSPTYGL	RTFSPTYGL
SVFELSNFA	SVFELSNFA
FIHFFTWGT	FIHFFTWGT
VLQAGFFLL	VLQAGFFLL
DLMLLSYSL	DLMLLSYSL
ALLGGLRPV	ALLGGLRPV
FQWHEAMFL	FQWHEAMFL
MLMAASRAL	MLMAASRAL
FMIDWILDA	FMIDWILDA
AIILASFSA	AIILASFSA
ILYQVPFSV	ILYQVPFSV
HLYASLSRV	HLYASLSRV
VTAEHLARL	VTAEHLARL
KQWIVAGAI	KQWIVAGAI
VTWHRYHLL	VTWHRYHLL
LTVKHMANV	LTVKHMANV
SLVITYCLV	SLVITYCLV
GLDYYVRSL	GLDYYVRSL
GLEAYIQGI	GLEAYIQGI
SLQQELAHM	SLQQELAHM
KMSGKTPAV	KMSGKTPAV
TLFIGSHVV	TLFIGSHVV
TLLNETAKV	TLLNETAKV
ILYDNVVTL	ILYDNVVTL
YTFTSLFSL	YTFTSLFSL
FIALNLSFI	FIALNLSFI
LMDSIFVST	LMDSIFVST
GILKSILKV	GILKSILKV
HLTRVGPYL	HLTRVGPYL
GLGQYIYET	GLGQYIYET
KMDIDVEYL	KMDIDVEYL
VLLLDVTPL	VLLLDVTPL
IAGGVMAVV	IAGGVMAVV
TVSERILPL	TVSERILPL
KINPTLDNI	KINPTLDNI
GMPNWCVSI	GMPNWCVSI
KLQAAVMET	KLQAAVMET
RLAEPLMDL	RLAEPLMDL
KLGKAGYVV	KLGKAGYVV
FIDSYLQKL	FIDSYLQKL
LLMTSLQYA	LLMTSLQYA
YLLFGIKCI	YLLFGIKCI
SLLLVVEGV	SLLLVVEGV
WLWYIKIFI	WLWYIKIFI
GLADQLIHM	GLADQLIHM
GLVDVCFWS	GLVDVCFWS
AVAKAAAAV	AVAKAAAAV
LLMLVTPSM	LLMLVTPSM
ILSPFMPLL	ILSPFMPLL
MLCGFSPAL	MLCGFSPAL
KLFTDNNFL	KLFTDNNFL
RIITILQDI	RIITILQDI
AMWLLLLSI	AMWLLLLSI
SPGGFVQFV	SPGGFVQFV
YILCNMALL	YILCNMALL
YIALCKVTV	YIALCKVTV
YLFPGPVTA	YLFPGPVTA
FTASLFLHL	FTASLFLHL
ALYNTAAAL	ALYNTAAAL
GLNGDSFRV	GLNGDSFRV
MLLAVLYCL	MLLAVLYCL
LLLPIAPEL	LLLPIAPEL
FVIFACNFV	FVIFACNFV
SLAIDAYPL	SLAIDAYPL
TTYVYTLPV	TTYVYTLPV
AIYVFCISL	AIYVFCISL
LLMEGLKLL	LLMEGLKLL
LLFKTSAGV	LLFKTSAGV
IILKALYML	IILKALYML
ELLEMKYAL	ELLEMKYAL
FIISTLNKI	FIISTLNKI
MTNNPPIPV	MTNNPPIPV
YLVAYKATV	YLVAYKATV
ITNGYLISI	ITNGYLISI
IISSKQYPA	IISSKQYPA
YLMCLSPLM	YLMCLSPLM
FMQALHLLL	FMQALHLLL
KIFEYGFTF	KIFEYGFTF
FIAPLGFSL	FIAPLGFSL
RTSFFLWVI	RTSFFLWVI
ILFSYDELV	ILFSYDELV
TLQSFRQDV	TLQSFRQDV
RVYKTIWEI	RVYKTIWEI
LLMGCDIVL	LLMGCDIVL
YLLEKSRAI	YLLEKSRAI
KQLEYSWVL	KQLEYSWVL
WLMWFIISI	WLMWFIISI
LLSNTLAEL	LLSNTLAEL
AMFTAALNI	AMFTAALNI
ALYYSVENV	ALYYSVENV
CLDAGINYV	CLDAGINYV
LMMSSPPPI	LMMSSPPPI
LLPFVQWFV	LLPFVQWFV
VLAGYGAGI	VLAGYGAGI
YLDEAGGHL	YLDEAGGHL
TLVPQEHYV	TLVPQEHYV
NIIDWQFAI	NIIDWQFAI
ALGYQLAFV	ALGYQLAFV
AVITETIPI	AVITETIPI
FLYGGLLLA	FLYGGLLLA
ALTIACMTV	ALTIACMTV
VLLEKAPPL	VLLEKAPPL
KMIYDLNAV	KMIYDLNAV
YQADLYTYL	YQADLYTYL
ILDAARPAV	ILDAARPAV
SMIFSVLDA	SMIFSVLDA
YLCTFMIIT	YLCTFMIIT
RMDLGVPLL	RMDLGVPLL
KLVGKLNWA	KLVGKLNWA
YQGSYGFRL	YQGSYGFRL
VVPCEPPEV	VVPCEPPEV
KLVAYQATV	KLVAYQATV
TFMDGTPEL	TFMDGTPEL
SLADISLGA	SLADISLGA
KASEYLQLV	KASEYLQLV
GLAWIPYFG	GLAWIPYFG
VLSDDLLEA	VLSDDLLEA
FLLPILSQI	FLLPILSQI
SISPIDWSV	SISPIDWSV
RAMASDFNL	RAMASDFNL
YASALVLLI	YASALVLLI
YLYFCSSDV	YLYFCSSDV
YMYDFILRF	YMYDFILRF
IVNSVLLFL	IVNSVLLFL
GLFPQLSAI	GLFPQLSAI
TLLCLIPTV	TLLCLIPTV
ALIYFLQCI	ALIYFLQCI
ALPDTVAPV	ALPDTVAPV
ILFQRTFSI	ILFQRTFSI
WLMKYPYQL	WLMKYPYQL
YLNTLTLAV	YLNTLTLAV
SVVALSPYV	SVVALSPYV
MILVPLITV	MILVPLITV
YTVAYQATV	YTVAYQATV
FMAYTTSHI	FMAYTTSHI
TLNHNCINV	TLNHNCINV
LLSQYLSRV	LLSQYLSRV
VLVGGVLAA	VLVGGVLAA
TLSRHIFMA	TLSRHIFMA
SLYLTVATL	SLYLTVATL
FVFDRPLPV	FVFDRPLPV
YMPDVLEKL	YMPDVLEKL
ALAKAAAAI	ALAKAAAAI
QLFEAHPNV	QLFEAHPNV
VLAGLLGNV	VLAGLLGNV
LLRVHTEHV	LLRVHTEHV
IIPFIAYFV	IIPFIAYFV
LMPLARFWL	LMPLARFWL
KTMAMVLSI	KTMAMVLSI
ELYSPLFLI	ELYSPLFLI
MMLSPLVAL	MMLSPLVAL
RLLGFADTV	RLLGFADTV
TLFLLFLEI	TLFLLFLEI
AMYGKHITL	AMYGKHITL
YMLKDSAPT	YMLKDSAPT
FLQPTADLL	FLQPTADLL
TLAPFNFLV	TLAPFNFLV
HLVEALYLV	HLVEALYLV
ILTAILFFM	ILTAILFFM
LMAAILAYT	LMAAILAYT
LLIHQGMHM	LLIHQGMHM
MRLLPLLAL	MRLLPLLAL
VVMGTLVAL	VVMGTLVAL
WLGNIIMYA	WLGNIIMYA
CLLQSLQQI	CLLQSLQQI
NLIYRNLHL	NLIYRNLHL
FLNQANCKI	FLNQANCKI
FTTSLFLHL	FTTSLFLHL
FLADKKMTL	FLADKKMTL
GMMRWCMPV	GMMRWCMPV
FAFRYVNRL	FAFRYVNRL
GIYHDICEI	GIYHDICEI
LMDENTYAM	LMDENTYAM
GLLGSLVGA	GLLGSLVGA
ILSQVPFSV	ILSQVPFSV
LLPLGYPFV	LLPLGYPFV
RILAYGPCL	RILAYGPCL
QMWKCLIRL	QMWKCLIRL
RLQFGPPPV	RLQFGPPPV
IMPQGEAGL	IMPQGEAGL
FQWPALHEE	FQWPALHEE
YALCTLLHL	YALCTLLHL
KLGSSIDRL	KLGSSIDRL
TLKDGDFIL	TLKDGDFIL
LMQSLYDWI	LMQSLYDWI
SIFLHLVKI	SIFLHLVKI
YTINCLLYI	YTINCLLYI
AIVGGLAEL	AIVGGLAEL
FLYDRLAST	FLYDRLAST
YMIKLAKEV	YMIKLAKEV
FQVDCFLWH	FQVDCFLWH
RVQFIPGQR	RVQFIPGQR
VLANFCSAL	VLANFCSAL
WLSDCGEAL	WLSDCGEAL
SLSPLQAEL	SLSPLQAEL
FVVALIPLV	FVVALIPLV
TVIEGLDKL	TVIEGLDKL
RMGELTAEI	RMGELTAEI
YLSPGPVTA	YLSPGPVTA
LIFFVIILA	LIFFVIILA
ILGIFNEFV	ILGIFNEFV
GLLPCLHVA	GLLPCLHVA
VILNYIPVL	VILNYIPVL
QSAGFAAGL	QSAGFAAGL
MLIEVILTA	MLIEVILTA
ALYWALMES	ALYWALMES
AIIDIEPDL	AIIDIEPDL
VMYAFTTPL	VMYAFTTPL
LLLEWLAEV	LLLEWLAEV
YLYGIGSAV	YLYGIGSAV
FTSAVLLLV	FTSAVLLLV
LLSTTEWQV	LLSTTEWQV
SMYCSKTFL	SMYCSKTFL
FLEDLSYPA	FLEDLSYPA
LIQDWIPPL	LIQDWIPPL
AIMEKNIML	AIMEKNIML
YIYGIPLSL	YIYGIPLSL
SMFASCNLL	SMFASCNLL
WLVHKQWFL	WLVHKQWFL
LLLAGIPLA	LLLAGIPLA
SLPPPGTRV	SLPPPGTRV
ALDCQIYGA	ALDCQIYGA
TLGTVILLV	TLGTVILLV
HMTEVVRRC	HMTEVVRRC
LMDGHTGMV	LMDGHTGMV
ELDSNLYRI	ELDSNLYRI
RLGAVILFV	RLGAVILFV
NLLDRLLLI	NLLDRLLLI
KLAEAIFKL	KLAEAIFKL
SVIFYFISI	SVIFYFISI
WLDSVIQYL	WLDSVIQYL
LLAKMLFYL	LLAKMLFYL
KLYDSVYLT	KLYDSVYLT
FLSYISDTV	FLSYISDTV
VLDGFIPGT	VLDGFIPGT
VLLPVLFGV	VLLPVLFGV
FMGVIYIMI	FMGVIYIMI
VMVTITQNV	VMVTITQNV
FLQDESAYV	FLQDESAYV
VLLRALPVL	VLLRALPVL
VVTGVLVYL	VVTGVLVYL
FLGGTTVCL	FLGGTTVCL
DLLNVKMAL	DLLNVKMAL
GVFHTMWHV	GVFHTMWHV
LAIVTTPLV	LAIVTTPLV
YLEPGPVTI	YLEPGPVTI
TLARGFPFV	TLARGFPFV
VLLPFYETL	VLLPFYETL
IISLWDQSL	IISLWDQSL
LIMYSVIGV	LIMYSVIGV
GTSAAAYFV	GTSAAAYFV
FLWGPRALA	FLWGPRALA
YLIGGSATL	YLIGGSATL
LLNLLLWPL	LLNLLLWPL
CILESLFRA	CILESLFRA
LLIQGLKTV	LLIQGLKTV
SQYANCSSI	SQYANCSSI
ILDGKNCTL	ILDGKNCTL
GLVGLVTFL	GLVGLVTFL
SLYNSVATL	SLYNSVATL
TQFAGVVTV	TQFAGVVTV
YPPPRYITV	YPPPRYITV
LLFRFMRPL	LLFRFMRPL
RLGAIPPLV	RLGAIPPLV
FQNWGIESI	FQNWGIESI
LLLEAGALV	LLLEAGALV
YLEPGPVTA	YLEPGPVTA
KMNIQFTAV	KMNIQFTAV
TMAMVLSIV	TMAMVLSIV
ILSNYVKTL	ILSNYVKTL
YLILFLLFV	YLILFLLFV
FLLMIVLQI	FLLMIVLQI
AMTAFFGEL	AMTAFFGEL
FAVQTIVFI	FAVQTIVFI
ILNGGLGNA	ILNGGLGNA
KMVEIPFNV	KMVEIPFNV
VLLGVVFGV	VLLGVVFGV
LPTWLGAAI	LPTWLGAAI
ALVEMGHHV	ALVEMGHHV
LLLHSLTPL	LLLHSLTPL
YTITVFLHL	YTITVFLHL
GLYLYRFHV	GLYLYRFHV
FGLAKLLGA	FGLAKLLGA
FWMSPVFNL	FWMSPVFNL
ALYGALLLA	ALYGALLLA
VMGTLVALV	VMGTLVALV
AMVGAVLTA	AMVGAVLTA
VLGDDLLEA	VLGDDLLEA
LLGPVIGML	LLGPVIGML
YQLEMYHPI	YQLEMYHPI
FVANFSMEL	FVANFSMEL
MMNITRLEV	MMNITRLEV
RLATHLRAV	RLATHLRAV
MVIACLLVA	MVIACLLVA
RLMRTNFLI	RLMRTNFLI
KECVDGTLL	KECVDGTLL
YMFESKSMK	YMFESKSMK
LAERFCTEV	LAERFCTEV
QMLSVVGFL	QMLSVVGFL
FMVYVPLPA	FMVYVPLPA
LIVGIIFTA	LIVGIIFTA
SMSSYDFST	SMSSYDFST
STISWMMKL	STISWMMKL
FTATSIARV	FTATSIARV
LLLVRAYWL	LLLVRAYWL
YAAEMVEYL	YAAEMVEYL
RVFKKIMSI	RVFKKIMSI
LLMNELLRV	LLMNELLRV
RMYGVLPWI	RMYGVLPWI
ALMDKSLHV	ALMDKSLHV
RLIDRMLTA	RLIDRMLTA
MLYPLLWMF	MLYPLLWMF
LLIAITAFT	LLIAITAFT
HLDGEVLSL	HLDGEVLSL
KQMSQPYAV	KQMSQPYAV
SVDFYQFRV	SVDFYQFRV
TLLDQNNAL	TLLDQNNAL
KLQDLTLRC	KLQDLTLRC
ALALEQYGI	ALALEQYGI
RLLCALTSL	RLLCALTSL
GLLGNVSTV	GLLGNVSTV
HLAVIGALL	HLAVIGALL
MVTDKTAYI	MVTDKTAYI
SLSHYFTLV	SLSHYFTLV
IQPGQTFSV	IQPGQTFSV
AVGFFPTGV	AVGFFPTGV
WLDQVPFSV	WLDQVPFSV
SLVEMMWDL	SLVEMMWDL
QLIFFLTLA	QLIFFLTLA
KLHCTERSL	KLHCTERSL
RLITANPIV	RLITANPIV
FLETDAGRV	FLETDAGRV
VLPAVVYST	VLPAVVYST
KISNTTFEV	KISNTTFEV
LLIEGIFFI	LLIEGIFFI
GILTVILGV	GILTVILGV
FLCAKCLGA	FLCAKCLGA
FADTVVACV	FADTVVACV
ALYGFVPVL	ALYGFVPVL
FLHSGTAKS	FLHSGTAKS
HQFTSNPEV	HQFTSNPEV
LLSIVPCTV	LLSIVPCTV
LMAVVLASL	LMAVVLASL
SLFNTVATV	SLFNTVATV
FLAIKLYGV	FLAIKLYGV
FQQLFLNTL	FQQLFLNTL
YIIDWMVDI	YIIDWMVDI
RLDSLDLTL	RLDSLDLTL
KLFSDISAI	KLFSDISAI
KLGEGFKSL	KLGEGFKSL
LIQEIVHEV	LIQEIVHEV
FMIVSISLV	FMIVSISLV
MLVNRMQRI	MLVNRMQRI
LLMDCSGSI	LLMDCSGSI
TSVDLNAPV	TSVDLNAPV
RVASPTSGV	RVASPTSGV
FMVSSIDEL	FMVSSIDEL
RLFTKVKPL	RLFTKVKPL
MAWGGSYIA	MAWGGSYIA
GLARLDALV	GLARLDALV
YIACRTSIV	YIACRTSIV
SLSHNFTLV	SLSHNFTLV
WLPTGTLLV	WLPTGTLLV
RLCLDVPPV	RLCLDVPPV
FLGGHVAVA	FLGGHVAVA
LLGGVMAAV	LLGGVMAAV
SLYNTISVL	SLYNTISVL
KLMALELFK	KLMALELFK
FMQALQLLL	FMQALQLLL
KLVVGAVGV	KLVVGAVGV
GLYNLLIRC	GLYNLLIRC
GVFEGIAVL	GVFEGIAVL
MLDLQPETT	MLDLQPETT
SLIDLLHKI	SLIDLLHKI
SILNTLRFL	SILNTLRFL
FMNRFYITT	FMNRFYITT
ARWLFPVYL	ARWLFPVYL
KLIDVSKCI	KLIDVSKCI
TILATLNTL	TILATLNTL
LLPDSDVFV	LLPDSDVFV
MLMTGTLAV	MLMTGTLAV
KIWEELSML	KIWEELSML
VLLGAPVVV	VLLGAPVVV
FVVYNLTGV	FVVYNLTGV
YIITCCLFA	YIITCCLFA
LMIGTAAAV	LMIGTAAAV
SLTCEVDAL	SLTCEVDAL
FVWLHYYSV	FVWLHYYSV
ILDSFDPLV	ILDSFDPLV
VLVVQPAPV	VLVVQPAPV
KLYIALCKV	KLYIALCKV
YADHGANQL	YADHGANQL
LLCLIFLLV	LLCLIFLLV
YQLAVTIMA	YQLAVTIMA
GLKSKTHAV	GLKSKTHAV
ILDEAYVMA	ILDEAYVMA
LYKTIVNIW	LYKTIVNIW
WITQCFLPV	WITQCFLPV
MQQAYQCIV	MQQAYQCIV
NVISKIYTL	NVISKIYTL
RLDAEYWSV	RLDAEYWSV
IMAIGIVSI	IMAIGIVSI
ILDKVLVHL	ILDKVLVHL
TMSIYIAVA	TMSIYIAVA
FLYGAALLA	FLYGAALLA
LQDSVDFSL	LQDSVDFSL
LMMTTIGIV	LMMTTIGIV
YQLAVTITA	YQLAVTITA
HLTPAQLSM	HLTPAQLSM
YLLEMLWRL	YLLEMLWRL
GVWALPDPI	GVWALPDPI
PLFKRGWRL	PLFKRGWRL
FIMIVGGLV	FIMIVGGLV
VLCGIAWYV	VLCGIAWYV
QLVDFLCGL	QLVDFLCGL
LLPEIAPNA	LLPEIAPNA
AMPKTIYEL	AMPKTIYEL
RLMNDWAEV	RLMNDWAEV
MMCPFLFLM	MMCPFLFLM
FTIGNMFSL	FTIGNMFSL
FIIFLFILL	FIIFLFILL
KMFCQLAKV	KMFCQLAKV
RTFSIPLGV	RTFSIPLGV
LLRRRPYPL	LLRRRPYPL
AIYGRPVSA	AIYGRPVSA
FTLNHVLAL	FTLNHVLAL
MITMSAFLI	MITMSAFLI
TISGNIYSA	TISGNIYSA
SLEEEIRFL	SLEEEIRFL
YVNAILYQI	YVNAILYQI
SIYEVGIVL	SIYEVGIVL
GLDVLTAKV	GLDVLTAKV
LLLGLMILL	LLLGLMILL
VTYECPLLV	VTYECPLLV
ALIGTMCGI	ALIGTMCGI
MTMLTRWKI	MTMLTRWKI
IIFLFILLL	IIFLFILLL
QLMPYGCLL	QLMPYGCLL
TIMAVLFVV	TIMAVLFVV
FVLPHWYMA	FVLPHWYMA
ALINDQLIM	ALINDQLIM
ELMYIFAAL	ELMYIFAAL
LLFFLALSI	LLFFLALSI
NMVPFFPPV	NMVPFFPPV
YLVAYQATL	YLVAYQATL
MIAAYTAAL	MIAAYTAAL
YLMTLMKGA	YLMTLMKGA
VLPPLSADL	VLPPLSADL
SLADQLIHL	SLADQLIHL
ALAAIENYV	ALAAIENYV
SQLAHLVYV	SQLAHLVYV
YLSRRLNPL	YLSRRLNPL
QLWTALVSL	QLWTALVSL
IVAQGIAAL	IVAQGIAAL
MLDDFSAGA	MLDDFSAGA
LLAALFHDI	LLAALFHDI
TVYPKTHYV	TVYPKTHYV
MMMLPATLA	MMMLPATLA
FALDRPCLV	FALDRPCLV
YLPDPTVGV	YLPDPTVGV
FLYCYFALV	FLYCYFALV
CLSDEINHV	CLSDEINHV
RIWSWLLGA	RIWSWLLGA
FAEGVVAFL	FAEGVVAFL
ALVELNSGV	ALVELNSGV
ATGDYVAFV	ATGDYVAFV
GLLDSIKMI	GLLDSIKMI
FLHEDTEKI	FLHEDTEKI
YILNKPVFI	YILNKPVFI
LMNNAFEWI	LMNNAFEWI
VVPSYIPLV	VVPSYIPLV
IMIGHLVGV	IMIGHLVGV
YFDDVTAFL	YFDDVTAFL
GLFGDIYLA	GLFGDIYLA
MLLALVALV	MLLALVALV
QMVSSVTFI	QMVSSVTFI
YIPPCQCTV	YIPPCQCTV
RLVDGVGGI	RLVDGVGGI
TMLLGVFTV	TMLLGVFTV
GTDGFPFKL	GTDGFPFKL
VLYGPDTPI	VLYGPDTPI
SLYSGFPSL	SLYSGFPSL
AMLAGTAVV	AMLAGTAVV
FLFDRLTNG	FLFDRLTNG
LLNATDIAV	LLNATDIAV
SLYNTVVTL	SLYNTVVTL
AVIGALLAV	AVIGALLAV
ALIFILLTA	ALIFILLTA
FLLGLLVHV	FLLGLLVHV
LISSDGARV	LISSDGARV
CQWGRLWQL	CQWGRLWQL
YILHSDYQL	YILHSDYQL
YILYIVFCI	YILYIVFCI
YLSPGPVTV	YLSPGPVTV
FLFFATSDV	FLFFATSDV
SIFISFYLI	SIFISFYLI
YLDFLLLLL	YLDFLLLLL
FLDQVPFSV	FLDQVPFSV
LLANNPPPV	LLANNPPPV
MLGTHTMEV	MLGTHTMEV
SVYVDAKLV	SVYVDAKLV
GLYEAIEEC	GLYEAIEEC
GLFPVSIPI	GLFPVSIPI
KMIPLLFIL	KMIPLLFIL
AVGELLAPV	AVGELLAPV
ETAWPFFYA	ETAWPFFYA
SLTTISTTL	SLTTISTTL
DMWEHAFYL	DMWEHAFYL
LLDFELACL	LLDFELACL
KLPRWIFFA	KLPRWIFFA
NLEKKITNV	NLEKKITNV
LLIDTGVYA	LLIDTGVYA
WTFTPTTPL	WTFTPTTPL
FLARFWTRA	FLARFWTRA
SRWAISHWL	SRWAISHWL
LMLHQQYNQ	LMLHQQYNQ
EMFGGTPAV	EMFGGTPAV
HLIKIPLLI	HLIKIPLLI
GLADQLIHI	GLADQLIHI
HLMSDNPKA	HLMSDNPKA
YFLESNFFI	YFLESNFFI
KLCSPVFAI	KLCSPVFAI
FLSLGLVSL	FLSLGLVSL
KLYFWIPWS	KLYFWIPWS
LQQSTYQLV	LQQSTYQLV
TVVPLMAFL	TVVPLMAFL
FLLKQFHAA	FLLKQFHAA
KLYERNTAF	KLYERNTAF
KLHRYIDSM	KLHRYIDSM
MMATIGIAL	MMATIGIAL
QLFPGLAAL	QLFPGLAAL
FIQNIDFKA	FIQNIDFKA
FTMRLLSPV	FTMRLLSPV
SHLVEALYL	SHLVEALYL
TIAVSVYGA	TIAVSVYGA
ILMHCQTTL	ILMHCQTTL
RFLEDYFGV	RFLEDYFGV
ILDPKTGLV	ILDPKTGLV
AVASGLLWV	AVASGLLWV
VTGCASLYV	VTGCASLYV
VLLLVTHYA	VLLLVTHYA
FIAGLIAIV	FIAGLIAIV
ITAQVPFSV	ITAQVPFSV
LLNETAKVI	LLNETAKVI
ALSMADIFI	ALSMADIFI
FMPDFDLHL	FMPDFDLHL
RMIAISAKV	RMIAISAKV
NVFKYLTSV	NVFKYLTSV
VLLLITHYA	VLLLITHYA
LMTFWNPPV	LMTFWNPPV
YMPTVIEHL	YMPTVIEHL
FLYGALRLA	FLYGALRLA
ILMYPTTLL	ILMYPTTLL
SVMDPLIYA	SVMDPLIYA
LIGNESFAL	LIGNESFAL
GLYGNGILV	GLYGNGILV
ELRRQVDQL	ELRRQVDQL
SLSMTCIAV	SLSMTCIAV
RLMIGTAAA	RLMIGTAAA
RLPHICYPV	RLPHICYPV
RLYPDAPPL	RLYPDAPPL
LLAVLYCLL	LLAVLYCLL
FVPYVLALV	FVPYVLALV
LIMFEQYFI	LIMFEQYFI
FTLVAPVSI	FTLVAPVSI
GLPRYVVCL	GLPRYVVCL
AIMDKNIIL	AIMDKNIIL
EMIRYMALV	EMIRYMALV
FLHEDLEKL	FLHEDLEKL
ALKGTNESL	ALKGTNESL
LLTEVETPI	LLTEVETPI
KLYEGDLRV	KLYEGDLRV
FLPWHRLFL	FLPWHRLFL
KLEEEQIIL	KLEEEQIIL
KVYDKLFPV	KVYDKLFPV
VLSDLCNFL	VLSDLCNFL
ALMEVTHVL	ALMEVTHVL
LLKLWIDKV	LLKLWIDKV
ILLMTVTSI	ILLMTVTSI
ILLVAVSFV	ILLVAVSFV
SIIDPLIYA	SIIDPLIYA
IVGAETFYV	IVGAETFYV
RLLDDLVIV	RLLDDLVIV
ALQTDNYTL	ALQTDNYTL
SLCSCICTV	SLCSCICTV
ILMHATYFL	ILMHATYFL
VMLDWGIEL	VMLDWGIEL
FLARLHAAA	FLARLHAAA
YLQYSISTA	YLQYSISTA
FLAMITYMT	FLAMITYMT
YVPGYSITT	YVPGYSITT
GMKAFTAAV	GMKAFTAAV
KIYKIIIWI	KIYKIIIWI
YLALLEACL	YLALLEACL
CLAEYCTSL	CLAEYCTSL
NIGAYVVLV	NIGAYVVLV
MIGNYFSGV	MIGNYFSGV
NLKDEQFPV	NLKDEQFPV
FLTYLDVSV	FLTYLDVSV
LQLGFSTGV	LQLGFSTGV
GLVDFVKHI	GLVDFVKHI
YLYQPCDLL	YLYQPCDLL
WLLIDTSNA	WLLIDTSNA
LLLAVAVYA	LLLAVAVYA
LMVHSTFLI	LMVHSTFLI
GLSRYVARV	GLSRYVARV
RIRKDFGKR	RIRKDFGKR
LLFGYAVYV	LLFGYAVYV
YLVAYQATT	YLVAYQATT
RTNDWDFVV	RTNDWDFVV
SLASLLPHV	SLASLLPHV
VLGAAVYAL	VLGAAVYAL
MLRDRWSLV	MLRDRWSLV
YLEPGPVTL	YLEPGPVTL
VLNTLMFMV	VLNTLMFMV
FMFNDLLKL	FMFNDLLKL
VVFVVFMGV	VVFVVFMGV
GLQADAPHL	GLQADAPHL
TLFPGDDDL	TLFPGDDDL
CLNEYHLFL	CLNEYHLFL
GLYEWISEQ	GLYEWISEQ
GLDTYVRSL	GLDTYVRSL
HMYFTFFDV	HMYFTFFDV
VLSDDLLEV	VLSDDLLEV
ILGTVSWNL	ILGTVSWNL
NQMIFVSSI	NQMIFVSSI
ALVGLFVLL	ALVGLFVLL
YLDVDLHPA	YLDVDLHPA
ILGAQALPV	ILGAQALPV
SMEAEMIQL	SMEAEMIQL
FLQQRKPPL	FLQQRKPPL
LLWQDPVPA	LLWQDPVPA
ALGYTTEEI	ALGYTTEEI
AMQDPNPEV	AMQDPNPEV
YLSQIAVLL	YLSQIAVLL
SMITMSAFL	SMITMSAFL
WMMAMRYPI	WMMAMRYPI
VLSDFKSWL	VLSDFKSWL
ELWWVFYAA	ELWWVFYAA
FMYEDALKS	FMYEDALKS
YVYPDNLPV	YVYPDNLPV
SLLMWITQV	SLLMWITQV
RLLPLWAAL	RLLPLWAAL
RLDARLQVL	RLDARLQVL
KLAGGVAVL	KLAGGVAVL
VLYCVHQEI	VLYCVHQEI
MTSCVSEQL	MTSCVSEQL
FIRDCSVAL	FIRDCSVAL
GLVSFNFLV	GLVSFNFLV
MVDVSMMSM	MVDVSMMSM
FLHESDPMV	FLHESDPMV
FLGSCICFI	FLGSCICFI
GLAAAVVAV	GLAAAVVAV
AIMDKNIML	AIMDKNIML
LLLISMYAL	LLLISMYAL
VLGSWPVDL	VLGSWPVDL
GLLCISIMI	GLLCISIMI
FLTTPVPSL	FLTTPVPSL
SMLSYGNVL	SMLSYGNVL
YLLDDVLYT	YLLDDVLYT
SVYNTVATL	SVYNTVATL
QVIFKCVPK	QVIFKCVPK
KIDSTSFSV	KIDSTSFSV
ALLQQTWTL	ALLQQTWTL
FLAGVPSAV	FLAGVPSAV
ALVLLMLPV	ALVLLMLPV
YLLLRVLNI	YLLLRVLNI
KMTFLFPNL	KMTFLFPNL
SLGQHIYET	SLGQHIYET
FLDLPLPWL	FLDLPLPWL
RTDAWSYPV	RTDAWSYPV
KTWKPTIFL	KTWKPTIFL
YTLNNGVAM	YTLNNGVAM
FLLDYEGTL	FLLDYEGTL
FVAVHPVDV	FVAVHPVDV
MLLATREYV	MLLATREYV
VLADDVYPL	VLADDVYPL
YLLALRYLA	YLLALRYLA
YMYAVSGAL	YMYAVSGAL
ALLALTRAI	ALLALTRAI
LLCPAGHAV	LLCPAGHAV
AIDDFCLFA	AIDDFCLFA
NTFYLFTFT	NTFYLFTFT
FGAQMGWPV	FGAQMGWPV
VLWSLLWLG	VLWSLLWLG
SLLWLGAGV	SLLWLGAGV
FLYGWLFIL	FLYGWLFIL
KLREYEAAL	KLREYEAAL
SLVTSFLLM	SLVTSFLLM
GQLASMVKL	GQLASMVKL
FLRGQAAAL	FLRGQAAAL
LLMLLPTAL	LLMLLPTAL
ITYQVPFSV	ITYQVPFSV
ALDEGLLPV	ALDEGLLPV
GLLFMILTV	GLLFMILTV
WLETELVFV	WLETELVFV
MLLVHYAII	MLLVHYAII
SLANTVATL	SLANTVATL
QLIPCMDVV	QLIPCMDVV
VLLAFLNSM	VLLAFLNSM
FSAVISGSV	FSAVISGSV
YMREVGAAL	YMREVGAAL
LLAPITAYA	LLAPITAYA
WQMFMKVTV	WQMFMKVTV
FLGDDPSPA	FLGDDPSPA
LVLNMVYSI	LVLNMVYSI
YLIPSVTSL	YLIPSVTSL
RQPLNIQAI	RQPLNIQAI
RLASSVFDL	RLASSVFDL
LLFLGVVFL	LLFLGVVFL
AIMTRCLAV	AIMTRCLAV
FLTQDLPLL	FLTQDLPLL
SQMTSTFIM	SQMTSTFIM
MSDIFHALV	MSDIFHALV
FQYYGIDWV	FQYYGIDWV
FMKDGRSLV	FMKDGRSLV
AIIDPLIYA	AIIDPLIYA
ALSNGIPPV	ALSNGIPPV
FLKPEETFV	FLKPEETFV
LVISGVFPV	LVISGVFPV
RMPAVTDLV	RMPAVTDLV
LQNFCQHLV	LQNFCQHLV
RAMRMVYYL	RAMRMVYYL
LLLAGTPAV	LLLAGTPAV
FILDALAQA	FILDALAQA
ILLPWFVDL	ILLPWFVDL
YTYKWETFL	YTYKWETFL
SLAALFYSL	SLAALFYSL
FLYGALVLA	FLYGALVLA
LLLRPFWPA	LLLRPFWPA
TLLVAVSFV	TLLVAVSFV
KLINTLFHA	KLINTLFHA
LLLWFNYLF	LLLWFNYLF
SLNRNFTLV	SLNRNFTLV
RLYQASAVM	RLYQASAVM
FLLALLSCL	FLLALLSCL
LLAFDTQPV	LLAFDTQPV
LLLLDVAPL	LLLLDVAPL
YLLPAIVHI	YLLPAIVHI
GLLGVVSTV	GLLGVVSTV
YLFQWNDNV	YLFQWNDNV
ALLAYRCVL	ALLAYRCVL
KVLEYVIKV	KVLEYVIKV
KIEIERKKL	KIEIERKKL
SQLPPACPV	SQLPPACPV
FIDGISLGL	FIDGISLGL
VLTEPLCQV	VLTEPLCQV
ALSPALTAL	ALSPALTAL
FLWSVFWLI	FLWSVFWLI
FLDEFMEAV	FLDEFMEAV
GLHAAAPHL	GLHAAAPHL
FTASVSTVV	FTASVSTVV
MLASTLTDA	MLASTLTDA
HLIFSYAFL	HLIFSYAFL
LLAQFQHTV	LLAQFQHTV
HMIAGVFFT	HMIAGVFFT
FLMRNAIQY	FLMRNAIQY
MIIMLIPTV	MIIMLIPTV
SVIDHIHYM	SVIDHIHYM
GHMMVIFRL	GHMMVIFRL
TLKDAMLQL	TLKDAMLQL
ILNDEQLNL	ILNDEQLNL
YLFGGFSTL	YLFGGFSTL
FLSAKTLTV	FLSAKTLTV
TMFKIVYSL	TMFKIVYSL
TLQDIVLHL	TLQDIVLHL
CLGGLLTMV	CLGGLLTMV
KLLPDTAAV	KLLPDTAAV
FLSAADDLV	FLSAADDLV
FMVAWGKEA	FMVAWGKEA
FLWHVRKRV	FLWHVRKRV
GLPRYVARL	GLPRYVARL
LVLFACSAV	LVLFACSAV
ILDAHSLYL	ILDAHSLYL
RMFAANLGV	RMFAANLGV
FLDEFMEGV	FLDEFMEGV
YIFSYDAYT	YIFSYDAYT
GLYPAQIKA	GLYPAQIKA
MLAKYDHLV	MLAKYDHLV
VLHSFTDAI	VLHSFTDAI
KVVSLVILA	KVVSLVILA
FVILYLLAV	FVILYLLAV
IMALKQAGL	IMALKQAGL
ILVCYILYI	ILVCYILYI
AMAKAAAAV	AMAKAAAAV
LLANTVRYL	LLANTVRYL
YLATGALLA	YLATGALLA
FIYLALLEA	FIYLALLEA
ALKMTMASV	ALKMTMASV
LAAEEILTL	LAAEEILTL
YVVIAILTV	YVVIAILTV
LLIAILGPL	LLIAILGPL
AVFGVVAIV	AVFGVVAIV
VLADAINGL	VLADAINGL
LLSLFSLWL	LLSLFSLWL
YMWLGARYL	YMWLGARYL
LLSALGLSV	LLSALGLSV
GLCIRISMV	GLCIRISMV
FLYGALYLA	FLYGALYLA
YLRQRQAAL	YLRQRQAAL
ILRKIFYSV	ILRKIFYSV
ALYNTVATL	ALYNTVATL
MLVGHMPFM	MLVGHMPFM
NLFDIPLLT	NLFDIPLLT
LIHQGMHMV	LIHQGMHMV
ELISSAFKV	ELISSAFKV
LIWKVNPEI	LIWKVNPEI
IAATYNFAV	IAATYNFAV
SVFSRPLPL	SVFSRPLPL
FLMQIAILV	FLMQIAILV
GLLIVKTVL	GLLIVKTVL
KFLDWMIFI	KFLDWMIFI
YLKAYQATV	YLKAYQATV
FANHDFTLV	FANHDFTLV
TISGVLWQV	TISGVLWQV
GMLECGFPT	GMLECGFPT
RRSLLAHVR	RRSLLAHVR
YLTSFVVPI	YLTSFVVPI
IVLSHILPL	IVLSHILPL
FLRYHCPGL	FLRYHCPGL
IIGAGPAEV	IIGAGPAEV
YLNTPGLPV	YLNTPGLPV
ALLSDWLPA	ALLSDWLPA
ALMTLDDLA	ALMTLDDLA
ATAKAAAAV	ATAKAAAAV
SQDEVLFLV	SQDEVLFLV
FLALIICNA	FLALIICNA
GLFPFHFTL	GLFPFHFTL
ALSSDGDTV	ALSSDGDTV
HLVDFQVTI	HLVDFQVTI
FLAALFYTS	FLAALFYTS
ILHEPVHGV	ILHEPVHGV
KTVLELTEV	KTVLELTEV
LMMTTIGVV	LMMTTIGVV
GIYCTVPFI	GIYCTVPFI
HLLCQAFSV	HLLCQAFSV
QLLDPPAAV	QLLDPPAAV
MLGNAPSVV	MLGNAPSVV
YLFPGPVYV	YLFPGPVYV
FVRELLTEV	FVRELLTEV
FLYNLLTRV	FLYNLLTRV
ILDQVPFSV	ILDQVPFSV
ALVACVAAL	ALVACVAAL
FLMDFIHQV	FLMDFIHQV
YLLNYAGRI	YLLNYAGRI
IISCTCPTV	IISCTCPTV
FIVEHINAM	FIVEHINAM
FTWYGIAAL	FTWYGIAAL
VTFDTLFMV	VTFDTLFMV
VMWAGPWSS	VMWAGPWSS
LLSCISVPV	LLSCISVPV
LMQDCAIKA	LMQDCAIKA
VLSPLPSQA	VLSPLPSQA
WQNLAWAGV	WQNLAWAGV
GLFFSVYAL	GLFFSVYAL
YLMPGPVTA	YLMPGPVTA
YLLGRPPNA	YLLGRPPNA
SLIPDATHL	SLIPDATHL
SLLALNEAL	SLLALNEAL
KMNNDVFFM	KMNNDVFFM
RLLTKPWDV	RLLTKPWDV
GMSLLEYGV	GMSLLEYGV
GMSRIGMEV	GMSRIGMEV
ALDHYDCLI	ALDHYDCLI
YLCDNFCPA	YLCDNFCPA
KIFRCLTVL	KIFRCLTVL
GLIPQWVTL	GLIPQWVTL
HLFTSMFSL	HLFTSMFSL
FMQPDNANL	FMQPDNANL
KQMEDGHTL	KQMEDGHTL
REFEAQNVP	REFEAQNVP
DLYDYITRI	DLYDYITRI
YLEPGPVTV	YLEPGPVTV
AQIGIFAPV	AQIGIFAPV
FLAPELVRA	FLAPELVRA
VLPPEINSL	VLPPEINSL
ILSPTAPSV	ILSPTAPSV
FVNHDFTVV	FVNHDFTVV
ILTGLNYEV	ILTGLNYEV
MQACPVDAI	MQACPVDAI
SLDAKQWSV	SLDAKQWSV
FVWQERAAV	FVWQERAAV
LLTFWNPPV	LLTFWNPPV
QVKDEKLNL	QVKDEKLNL
YLACKQHAL	YLACKQHAL
CLMMILPAA	CLMMILPAA
FLGGTPVCL	FLGGTPVCL
CLVSGLSSL	CLVSGLSSL
SLMNVDAAV	SLMNVDAAV
LVISGLFPV	LVISGLFPV
FMPDFSRVI	FMPDFSRVI
SLYNAIATL	SLYNAIATL
WLKEKHEEL	WLKEKHEEL
