Data	Data aligned
GLAVVLWSL	GLAVVLWSL
LAIVTTPLV	LAIVTTPLV
TMSAFLIVRL	TMSALIVRL
IMPKAGLLIIV	IMPKAGLLI
VIVIYIFTV	VIVIYIFTV
YFHALVYFV	YFHALVYFV
KLLPEGYWV	KLLPEGYWV
ATISYRIKL	ATISYRIKL
IMFKDDNII	IMFKDDNII
LIYSMEFTNL	LIYSEFTNL
NLDISSVQL	NLDISSVQL
KLLSTSNVI	KLLSTSNVI
KIFGSLAFL	KIFGSLAFL
TLKPGTMSV	TLKPGTMSV
FIASKGVKLV	FIASGVKLV
AMDLVLAAV	AMDLVLAAV
TVSDYISEL	TVSDYISEL
YMNGTMSQV	YMNGTMSQV
YMLDLQPET	YMLDLQPET
WMNRLIAFA	WMNRLIAFA
MQIRGFVYFV	QIRGFVYFV
TLFGRGVIDT	TLFGGVIDT
LLPSLFLLL	LLPSLFLLL
LLGRNSFEV	LLGRNSFEV
YLLSGSDLFI	LLSGSDLFI
MMMLPATLA	MMMLPATLA
LLGCIITSL	LLGCIITSL
TLMAMDLGEL	TLMADLGEL
GMGQKDSYV	GMGQKDSYV
SLSAYIIRV	SLSAYIIRV
FLLMDALKL	FLLMDALKL
RIRKDFGKR	RIRKDFGKR
FLARLIWWL	FLARLIWWL
LLDSHYESV	LLDSHYESV
YIDAYVSRL	YIDAYVSRL
VLITMLSIIL	VLITLSIIL
LLDDLGFSA	LLDDLGFSA
GVFHTMWHV	GVFHTMWHV
HLMFYTLPI	HLMFYTLPI
LMDCIMFDA	LMDCIMFDA
NVWATHACV	NVWATHACV
IMDASSFTL	IMDASSFTL
LMIGNYFSGV	LMIGYFSGV
SLENFRAYV	SLENFRAYV
KLTDWDFVV	KLTDWDFVV
ALGERLDAV	ALGERLDAV
QLAGYILTV	QLAGYILTV
ALLSCISVPV	LLSCISVPV
NVIEDITFL	NVIEDITFL
FLAFVVFLL	FLAFVVFLL
FVNYNFTLV	FVNYNFTLV
SQVSFQQPL	SQVSFQQPL
KLTADGVLTA	KLTAGVLTA
GLLGNVSTV	GLLGNVSTV
MLLTFLTSLL	MLLTFLTSL
ALRTDYNASV	ALRTYNASV
LLNLLLWPL	LLNLLLWPL
FLWGPRALV	FLWGPRALV
TLLGLILFVL	TLLGLILFV
FAFRDLCIV	FAFRDLCIV
AIMDKNIIL	AIMDKNIIL
SLLWLGAGV	SLLWLGAGV
SVLLFLAFV	SVLLFLAFV
SLFNTVATLY	SLFNTVATL
FLSHNFTLVF	FLSHNFTLV
VLMVDSFDPV	LMVDSFDPV
FLIVSLCPT	FLIVSLCPT
LLAENLPGL	LLAENLPGL
MLVNRMQRI	MLVNRMQRI
YTINCLLYI	YTINCLLYI
ILGFVFTLTV	ILGFFTLTV
MQQAYQCIV	MQQAYQCIV
YLTAIQDFI	YLTAIQDFI
AVGFFPTGV	AVGFFPTGV
SIDIETESV	SIDIETESV
TLYDFDYYI	TLYDFDYYI
RLLGSLNST	RLLGSLNST
VLLTYFCFV	VLLTYFCFV
MMLSPLVAL	MMLSPLVAL
LLGLWGLATA	LLGLGLATA
SLQEEIAFL	SLQEEIAFL
FIYLALLEA	FIYLALLEA
KQYLNLYPV	KQYLNLYPV
WVWDTWPLA	WVWDTWPLA
FLPKAAFAL	FLPKAAFAL
VLSFCAFAV	VLSFCAFAV
FLLLTSIPI	FLLLTSIPI
YCNYTRFWYI	YCNYRFWYI
LLTFWNPPV	LLTFWNPPV
FQQLFLNTL	FQQLFLNTL
ATNIFPFFV	ATNIFPFFV
ALLRMCALV	ALLRMCALV
IVFVFILTA	IVFVFILTA
KMEYNLYAEL	KMEYLYAEL
IVYCLNALV	IVYCLNALV
YQLAGYILT	YQLAGYILT
WLTSILLSL	WLTSILLSL
IMAVGLVSL	IMAVGLVSL
MIIGEPIIVA	MIIGEPIIV
AQPGLLSYV	AQPGLLSYV
TLGMCCIITA	TLGMCIITA
IMYTYFSNTI	IMYTFSNTI
GLFLTTEAV	GLFLTTEAV
VLAPYMPDV	VLAPYMPDV
ILSNKLLYAA	ILSNKLLYA
FTDQVPFSV	FTDQVPFSV
MIFISSFLL	MIFISSFLL
LLSTTEWQV	LLSTTEWQV
SLFKNVRLL	SLFKNVRLL
FLISVIVLV	FLISVIVLV
KVLSIMAFIL	KVLSIMAFI
SILNTLRFL	SILNTLRFL
IMDEPTSSL	IMDEPTSSL
SMFLMTATL	SMFLMTATL
SLFEGVDFYT	SLFEVDFYT
KVAELVHFL	KVAELVHFL
YLRGHTESI	YLRGHTESI
FLCLFLLPSL	FLCLLLPSL
VIGLIVILFI	VIGLVILFI
KMIYDLNAV	KMIYDLNAV
NIWAIIPLSA	NIWAIPLSA
LLLAGIPLA	LLLAGIPLA
SLSHYFTLV	SLSHYFTLV
NLVKWPLLNI	NLVKPLLNI
KLYIALCKV	KLYIALCKV
FANHAFTLV	FANHAFTLV
SMLGIWFFT	SMLGIWFFT
TLLGLILFV	TLLGLILFV
LLAVAVYAV	LLAVAVYAV
RLPRIFCSC	RLPRIFCSC
IIVALTIMGV	IIVATIMGV
MTPSPFYTV	MTPSPFYTV
FTFEWNGRI	FTFEWNGRI
ALAPSTMKI	ALAPSTMKI
SLSLHPLYV	SLSLHPLYV
ALSELPETL	ALSELPETL
YASALVLLI	YASALVLLI
YILRGLLEA	YILRGLLEA
ILDDNLYKV	ILDDNLYKV
FVSALCMFL	FVSALCMFL
YTMDGEYRL	YTMDGEYRL
FLGGTTVCL	FLGGTTVCL
QMLSVVGFLV	MLSVVGFLV
FQFICNLLLL	FQFICNLLL
NLFDIPLLT	NLFDIPLLT
LLAKMLFYL	LLAKMLFYL
FLFFATSDV	FLFFATSDV
WVMDTLNGI	WVMDTLNGI
VLYCVHQEI	VLYCVHQEI
NLEKKITNV	NLEKKITNV
ILAGYGAGV	ILAGYGAGV
KLSPSPSSRV	KLSPPSSRV
KQMSQPYAV	KQMSQPYAV
YLDEAGGHL	YLDEAGGHL
LVPFVQWFV	LVPFVQWFV
LLYILRYIV	LLYILRYIV
VLLVSLGAI	VLLVSLGAI
QLIFFLTLA	QLIFFLTLA
MMWYWGPSL	MMWYWGPSL
FVSTMPVETL	FVSTPVETL
HMWNFISGI	HMWNFISGI
FLAVFQSAT	FLAVFQSAT
ALAKAAAAI	ALAKAAAAI
ALGMRGLVL	ALGMRGLVL
ILAIIFLVL	ILAIIFLVL
SLHSLSVETI	SLHSSVETI
FMYSDFHFI	FMYSDFHFI
SIDHCSSFIV	SIDHCSSFI
SVYVDAKLV	SVYVDAKLV
ELQKFSFKI	ELQKFSFKI
VLQQNNSFI	VLQQNNSFI
NLWNGIVPT	NLWNGIVPT
VLMLVAHYA	VLMLVAHYA
ALVEICTEM	ALVEICTEM
LLIDTGVYA	LLIDTGVYA
KVFFGPIYYL	KVFFPIYYL
YLMPYSVYI	YLMPYSVYI
LISLINSLV	LISLINSLV
SLNQTVHSL	SLNQTVHSL
IAMWLLLLSI	AMWLLLLSI
KLGSSIDRL	KLGSSIDRL
KLRNWQWWRL	KLRNQWWRL
ILLTLRMTQL	ILLTRMTQL
GLIEEMASA	GLIEEMASA
AAGIGILTV	AAGIGILTV
DLMGYIPLV	DLMGYIPLV
GLYCYFTHL	GLYCYFTHL
SIVCIVAAV	SIVCIVAAV
LLSGLPTYA	LLSGLPTYA
YLVQQESSFV	YLVQESSFV
FLPIIFDAFL	FLPIFDAFL
FLLDYEGTL	FLLDYEGTL
NLAEDIMRL	NLAEDIMRL
TLNFPISPI	TLNFPISPI
KLNVGDYFV	KLNVGDYFV
KLSGLGLNAV	KLSGGLNAV
NVFISPASI	NVFISPASI
ILSVSSFLFV	ILSVSFLFV
GLFQLIFFL	GLFQLIFFL
YLEPGPVTI	YLEPGPVTI
WILRGTSFV	WILRGTSFV
LLMCAVHPEL	LLMCVHPEL
AMDSNTLEL	AMDSNTLEL
VIFILLMLV	VIFILLMLV
KLITFLFVI	KLITFLFVI
YIIDKDTNSV	YIIDDTNSV
FLLADERVRV	FLLAERVRV
KISNTTFEV	KISNTTFEV
HMYFTFFDV	HMYFTFFDV
ALSTGLIHL	ALSTGLIHL
KLVDICDRIV	KLVDICDRI
RIIDSEVVV	RIIDSEVVV
RLLPSLLLLL	LLPSLLLLL
QLVFGIELMEV	LVFGELMEV
VLQAVGACV	VLQAVGACV
MTYAAPLFV	MTYAAPLFV
STYPGNTFV	STYPGNTFV
CISSCNPNL	CISSCNPNL
RQPLNIQAI	RQPLNIQAI
YLCRHCLNLL	YLCRCLNLL
FVAEGDALV	FVAEGDALV
YLGHSAGFTA	YLGHAGFTA
YLIPAVTSL	YLIPAVTSL
YIYYFFIRL	YIYYFFIRL
QLWPEEIGV	QLWPEEIGV
KMIPLLFIL	KMIPLLFIL
KLIDVSKCI	KLIDVSKCI
VMWKCLIRL	VMWKCLIRL
GTTSLFLHL	GTTSLFLHL
YLSSWTPVV	YLSSWTPVV
VIADYNYKL	VIADYNYKL
ILTLDIFYL	ILTLDIFYL
KSLFNTIAVL	SLFNTIAVL
SLQPRSHSV	SLQPRSHSV
LTLDEQIFV	LTLDEQIFV
FLIDLAFLI	FLIDLAFLI
VLMTHFFSVL	VLMTHFFSV
GLIAIVMVTI	GLIAVMVTI
KSLFNTVATLY	SLFNTVATL
FMISFDDIAV	FMISDDIAV
TLNHNCINV	TLNHNCINV
MIGNYFSGV	MIGNYFSGV
VQSVLRDISI	VQSVRDISI
VLNTLMFMV	VLNTLMFMV
ALMDCIMFDA	ALMDIMFDA
YLAKLTALV	YLAKLTALV
FTFSNVCESV	FTFSVCESV
FLIVAALVFL	FLIVALVFL
YQLWTALVSL	QLWTALVSL
YLLSLFSTLV	YLLSFSTLV
VQTLISLNSM	QTLISLNSM
EAAAATCALV	AAAATCALV
ALYDVVSTL	ALYDVVSTL
FAMTVPLLI	FAMTVPLLI
EALNIALVAV	ALNIALVAV
KLYGYASLTT	KLYGYASLT
GLDYYVRSL	GLDYYVRSL
LIVAALVFL	LIVAALVFL
KQIMECSRML	QIMECSRML
KLFIRQEEV	KLFIRQEEV
KVAELVHFLL	KVAELVHFL
NIFMTLVPV	NIFMTLVPV
FALDRPCLV	FALDRPCLV
HLINKLLST	HLINKLLST
IIGAGPAEV	IIGAGPAEV
RNHLRDLMGV	NHLRDLMGV
IVVPVIDRL	IVVPVIDRL
LALVLLMLPV	ALVLLMLPV
FMNEDHWFS	FMNEDHWFS
RLLDDLVIV	RLLDDLVIV
SQFSYKELYV	SQFSKELYV
IISAVVGILL	IISAVGILL
LLFLMSFTI	LLFLMSFTI
HIMPNSFRV	HIMPNSFRV
NLLEQLIENI	LLEQLIENI
AMTAFFGEL	AMTAFFGEL
SVVIYDFLV	SVVIYDFLV
QLNDYEQLL	QLNDYEQLL
SLLNATDIAV	LLNATDIAV
FLSAKTLTV	FLSAKTLTV
LLLCLIFLL	LLLCLIFLL
ITAIYVFCI	ITAIYVFCI
FLLAKLTDI	FLLAKLTDI
FIMRNFLRSI	FIMRFLRSI
ILATLNTLIT	ILATLNTLI
FLPADFFPSV	FLPAFFPSV
LVISGLFPV	LVISGLFPV
SLAIDAYPL	SLAIDAYPL
FLLPLTSLV	FLLPLTSLV
LLPIFFCLWV	LLPIFCLWV
KLVGLGLNAV	KLVGGLNAV
RMFAANLGV	RMFAANLGV
MLDVDLHPA	MLDVDLHPA
KINPTLDNI	KINPTLDNI
ATLGTVILLV	TLGTVILLV
KLLALLGQV	KLLALLGQV
RQNAPFEPI	RQNAPFEPI
TMLEDHEFV	TMLEDHEFV
AMQTMLFTM	AMQTMLFTM
LLYDANYFV	LLYDANYFV
GMIPFFDFA	GMIPFFDFA
TLLGCWSFV	TLLGCWSFV
ALDCQIYGA	ALDCQIYGA
ATFRDMLLNV	ATFRMLLNV
DTMSIYIAVA	TMSIYIAVA
RLLDDTPEV	RLLDDTPEV
WMIHTLEAL	WMIHTLEAL
SVIFYFISI	SVIFYFISI
TLLLLGLMIL	LLLLGLMIL
ILNAMIAKI	ILNAMIAKI
SLIASSPGGD	SLIASSPGG
FLLMIVLQI	FLLMIVLQI
KLVMAFIAFL	LVMAFIAFL
IVSKLTFLDV	IVSKTFLDV
YLVSIFLHL	YLVSIFLHL
GLKISLCGI	GLKISLCGI
VLPPLSADL	VLPPLSADL
YIDISDVKV	YIDISDVKV
FLPSDYFPSP	FLPSDYFPS
MMAKEEELV	MMAKEEELV
SLSVSLVLV	SLSVSLVLV
GLFIYIPGT	GLFIYIPGT
FLALVSNRV	FLALVSNRV
FVFDRPLPV	FVFDRPLPV
AIIPLSASV	AIIPLSASV
VLYHRYNLV	VLYHRYNLV
ALMDLLMFS	ALMDLLMFS
SLLALNEAL	SLLALNEAL
RLYDYFTRV	RLYDYFTRV
YMDLSYHGV	YMDLSYHGV
SAFNDDGIYI	SAFNDGIYI
QLLDVKLAL	QLLDVKLAL
ELMRRGDLPV	LMRRGDLPV
MVTDKTAYI	MVTDKTAYI
FLPSDYFPKV	FLPSYFPKV
IILLFDFSI	IILLFDFSI
HVLLPFYETL	VLLPFYETL
TTWEDVPYL	TTWEDVPYL
LMYKGLPWNV	LMYKLPWNV
HLFTSMFSL	HLFTSMFSL
KVYDKLFPV	KVYDKLFPV
ALATALTEA	ALATALTEA
LLAVGATKV	LLAVGATKV
FVFNGTSWFI	FVFNTSWFI
KLFYVYYNL	KLFYVYYNL
KVLFLAAFV	KVLFLAAFV
FLSHNFTLV	FLSHNFTLV
MLLHVGIPL	MLLHVGIPL
VNNAVVMPA	VNNAVVMPA
YLYNKYSFKL	YLYNYSFKL
VLPVPGASV	VLPVPGASV
KMDSFLDMQL	KMDSLDMQL
LMQWWSDYV	LMQWWSDYV
LYKTIVNIW	LYKTIVNIW
LIDFYLCFL	LIDFYLCFL
KLRRGDLPFV	KLRRDLPFV
RIYCSLFKNV	RIYCLFKNV
QIMECSRML	QIMECSRML
KLFTHDIML	KLFTHDIML
NCLTLLLSV	NCLTLLLSV
LMMTTIGVV	LMMTTIGVV
GVYDYLVST	GVYDYLVST
FLYDRLAST	FLYDRLAST
FLSYISDTV	FLSYISDTV
FANHKFTLV	FANHKFTLV
AMTMFYPGV	AMTMFYPGV
SLFSLLLVI	SLFSLLLVI
TLLDQNNAL	TLLDQNNAL
SLSSQLSNL	SLSSQLSNL
LMNNAFEWI	LMNNAFEWI
YLSAKVYML	YLSAKVYML
YLYETYHLI	YLYETYHLI
KIMEIVSHL	KIMEIVSHL
YILGFAIPI	YILGFAIPI
LLDVPTAAV	LLDVPTAAV
GLSRYVARL	GLSRYVARL
GLLYFILFFV	LLYFILFFV
ALMIAAQVVV	LMIAAQVVV
FLKKLHEEEI	FLKKHEEEI
VMFNGVTFST	VMFNVTFST
KMIYDLNAVT	KMIYDLNAV
ALVGLFVLL	ALVGLFVLL
QLSGLGINAV	QLSGGINAV
RTVIHLEWLL	TVIHLEWLL
KLPTWLGAA	KLPTWLGAA
ILFDRLPIA	ILFDRLPIA
AMFTAALNI	AMFTAALNI
GLIMVLSFL	GLIMVLSFL
ALWEIQQVV	ALWEIQQVV
SQYYFSMLV	SQYYFSMLV
FLLPILSQI	FLLPILSQI
LIAGIILLI	LIAGIILLI
MLMEVFPQL	MLMEVFPQL
RLPPNTFFA	RLPPNTFFA
FLFILLLCLI	FLFILLLCL
GILGTIIFA	GILGTIIFA
GLTEVFGST	GLTEVFGST
YTFLYNFWT	YTFLYNFWT
LLVQRVTSV	LLVQRVTSV
LISFFGLFDI	LISFGLFDI
KLVDICDRI	KLVDICDRI
FVDTMSIYI	FVDTMSIYI
EQEFLTAAL	EQEFLTAAL
FLFWFLKSGA	FLFWLKSGA
ILLMTVTSI	ILLMTVTSI
ALLPAPITL	ALLPAPITL
ILGMLFSDRV	ILGMFSDRV
YLGMFNPYSL	YLGMNPYSL
VVFLHVTYV	VVFLHVTYV
NVDNLIMIV	NVDNLIMIV
ALIANIHNHM	ALIAIHNHM
SLSPLQAEL	SLSPLQAEL
LMWLSYFVA	LMWLSYFVA
YLDDHRYLFI	YLDDRYLFI
ALNIALIAV	ALNIALIAV
SIILEFFLIV	IILEFFLIV
FIISTLNKI	FIISTLNKI
RLVPGATYAL	RLVPATYAL
LLLGLWGTAA	LLLGWGTAA
ILSPTAPSV	ILSPTAPSV
NQNDNEETV	NQNDNEETV
FLPQIGGEAI	FLPQGGEAI
TLTRGQNTV	TLTRGQNTV
GLFQFFVFL	GLFQFFVFL
TLYAVATTV	TLYAVATTV
ALFSGVSWI	ALFSGVSWI
EMDKDDESL	EMDKDDESL
LILSNKLLYA	ILSNKLLYA
FLLRGPFEAS	FLLRGPFEA
GLHCDFACL	GLHCDFACL
TIKESLLKET	TIKELLKET
QLFNHTMFI	QLFNHTMFI
FLSFASLFL	FLSFASLFL
KVLSIMAFI	KVLSIMAFI
GLLFMILTV	GLLFMILTV
RMPAVTDLV	RMPAVTDLV
ILMDSIFVST	ILMDIFVST
ALWIPDLFM	ALWIPDLFM
YLMDKLNLT	YLMDKLNLT
SLVKPTVYV	SLVKPTVYV
YMIMVKCWMI	YMIMKCWMI
YMNYYTTYI	YMNYYTTYI
LLMEGLKLL	LLMEGLKLL
IMAAILAYT	IMAAILAYT
YLLPGFVLT	YLLPGFVLT
WAPEGDIRL	WAPEGDIRL
CVMYASALV	CVMYASALV
WITQCFLPV	WITQCFLPV
MLLTFLTSL	MLLTFLTSL
NIYSALMTL	NIYSALMTL
SMHFYGWSL	SMHFYGWSL
ILLWEIPDV	ILLWEIPDV
IITNAGTCTV	ITNAGTCTV
LTFGWCFKL	LTFGWCFKL
IILVIIVVI	IILVIIVVI
FVAVHPVDV	FVAVHPVDV
QLVDAIDNIV	QLVDAIDNI
YTAFTIPSI	YTAFTIPSI
IQYRQQLEL	IQYRQQLEL
RLYQASAVM	RLYQASAVM
LLAPGPLFV	LLAPGPLFV
IAPNASLGV	IAPNASLGV
FLPSDYFPSI	FLPSYFPSI
YVHGDTYSL	YVHGDTYSL
YLSGTDDEVI	YLSGTDDEV
FLNKRIFSEV	FLNKIFSEV
ITWQVPFSV	ITWQVPFSV
YILCNMALL	YILCNMALL
EMVEYLENQL	MVEYLENQL
FVFSTSFYL	FVFSTSFYL
KLLTKPWDV	KLLTKPWDV
KLVSLGVNAV	KLVSGVNAV
VMGTLVALV	VMGTLVALV
PLFKRGWRL	PLFKRGWRL
AMALLRLPLV	AMALRLPLV
ALYSYASAK	ALYSYASAK
RVYEALYYV	RVYEALYYV
YLLGDSDSVA	YLLGDSDSV
TIATYIDALA	TIATYIDAL
FLLALLSCLT	FLLALLSCL
TAAAWYLWEV	AAAWYLWEV
VMYAFTTPLI	VMYAFTTPL
FLVPGTHVA	FLVPGTHVA
FLAHAIGTSI	FLAHIGTSI
FTILEYLYIM	FTILEYLYI
VLQQSTYQL	VLQQSTYQL
ILYSVLQHL	ILYSVLQHL
STSFYLISI	STSFYLISI
YLQYSISTA	YLQYSISTA
LLNMRDLIV	LLNMRDLIV
GLSRYVARV	GLSRYVARV
TLLELVVSV	TLLELVVSV
GLLLLLLLLG	GLLLLLLLL
LLVKLALITV	LLVKALITV
GVWALPDPI	GVWALPDPI
YMSNLFDIPL	YMSNFDIPL
IMTSYQYLI	IMTSYQYLI
QLVDAIDNI	QLVDAIDNI
SLVITYCLVT	SLVITYCLV
SLAGGIIGV	SLAGGIIGV
NLKDEQFPV	NLKDEQFPV
WLIDYVEDT	WLIDYVEDT
RSLFNTVAVL	SLFNTVAVL
RILHNGAYSL	ILHNGAYSL
LLLWISVKV	LLLWISVKV
DLYDMIHNV	DLYDMIHNV
GLKIEEIEKV	GLKIEIEKV
VLMEAQQGI	VLMEAQQGI
LMTLYQIQV	LMTLYQIQV
QIFNIISYII	QIFNIISYI
YLHTLWKAGI	YLHTWKAGI
FLHTTFIDV	FLHTTFIDV
AIYSAILLLV	AIYSILLLV
LWMRLLPLLA	WMRLLPLLA
MAFDISVNA	MAFDISVNA
MLAESCDSV	MLAESCDSV
YQYIFLSFFA	YQYILSFFA
CMINDTHFLL	MINDTHFLL
ILDEAYVMA	ILDEAYVMA
NLNELVKHGL	NLNEVKHGL
VILAGPMPV	VILAGPMPV
TLIDVCPI	TLID-VCPI
YMLDLQPETT	YMLDLQPET
FSTSAYLISI	STSAYLISI
TFMDGTPEL	TFMDGTPEL
VLCPYMPKV	VLCPYMPKV
GMIIMLIPTV	MIIMLIPTV
ALCKVTVPT	ALCKVTVPT
TLLIKTLSPA	LLIKTLSPA
LNISGYNFSL	NISGYNFSL
ALTDLGLLYT	ALTDGLLYT
AVVMSWAPPV	VVMSWAPPV
KAACWWAGI	KAACWWAGI
RLMELPVKT	RLMELPVKT
GLAVDLYAL	GLAVDLYAL
HLDFWHHEV	HLDFWHHEV
ALAKAAAAM	ALAKAAAAM
LLDEYRDYI	LLDEYRDYI
GLGPTLMCL	GLGPTLMCL
YLPDPTVGV	YLPDPTVGV
TIGNQLYLTV	TIGNLYLTV
VLVDNVDFA	VLVDNVDFA
SLLDEDSKI	SLLDEDSKI
LIVGIIFTA	LIVGIIFTA
SMWSFNPET	SMWSFNPET
QMAGVEVRYI	QMAGEVRYI
IILEFFLIV	IILEFFLIV
FIRDCSVAL	FIRDCSVAL
VMVKINPTL	VMVKINPTL
GLLPSLLLLL	LLPSLLLLL
SLYSILSPFL	SLYSLSPFL
YMHGSIHEV	YMHGSIHEV
ALIHHNTHL	ALIHHNTHL
KLLLWFNYL	KLLLWFNYL
YLMPGPVTA	YLMPGPVTA
FLDWIKDIM	FLDWIKDIM
RILPYTFKI	RILPYTFKI
MTFGDIPLV	MTFGDIPLV
LLFNILGGWV	LLFNLGGWV
FLTREILWA	FLTREILWA
FLMPFMHYIV	FLMPFMHYI
SLFNTIAVLY	SLFNTIAVL
CLMTYSHHA	CLMTYSHHA
FTLLFQLCT	FTLLFQLCT
LLLLVAHYAI	LLLLVAHYA
AVAKAAAAV	AVAKAAAAV
YLFPGPVTA	YLFPGPVTA
CQWGRLWQL	CQWGRLWQL
YVFTLLFQL	YVFTLLFQL
FIYSIMETI	FIYSIMETI
YLGPRVCWL	YLGPRVCWL
MLLALIAVL	MLLALIAVL
VTFDTLFMV	VTFDTLFMV
GVFIQVYEV	GVFIQVYEV
FMECNLNELV	FMECLNELV
AIIDIEPDL	AIIDIEPDL
AMFIGHATA	AMFIGHATA
ILYYGANGST	ILYYANGST
ALVSEVTEV	ALVSEVTEV
MLTNASGHA	MLTNASGHA
SVDFYQFRV	SVDFYQFRV
KLIEYSDFA	KLIEYSDFA
SLNRTIVTKV	SLNRIVTKV
ILIGVIITWI	ILIGIITWI
SLQECVKMA	SLQECVKMA
VLSIMAFIL	VLSIMAFIL
NVGRILGYV	NVGRILGYV
GMLSSLHTL	GMLSSLHTL
SLLYLILFL	SLLYLILFL
TLHEYMLDL	TLHEYMLDL
RMILYLESV	RMILYLESV
KQYGDIDLL	KQYGDIDLL
LLSIVPCTV	LLSIVPCTV
MMNERDVSV	MMNERDVSV
YALCTLLHL	YALCTLLHL
TIWAANAGV	TIWAANAGV
WLGNHGFEV	WLGNHGFEV
VLWKSYPLV	VLWKSYPLV
VLYGPDAPTI	VLYGDAPTI
LISSDGARV	LISSDGARV
FLAHYIGTSL	FLAHIGTSL
WQMFMKVTV	WQMFMKVTV
FAAELTIGV	FAAELTIGV
VLTSVDIET	VLTSVDIET
TTLSRHIFMA	TLSRHIFMA
KLKSLYNTV	KLKSLYNTV
GMSWITQGL	GMSWITQGL
YLYIMRVMA	YLYIMRVMA
FIHGGILYA	FIHGGILYA
WLLPLWAAL	WLLPLWAAL
WLLIDTSNA	WLLIDTSNA
VMSELEFYL	VMSELEFYL
GLLEWIFRAL	GLLEWIFRA
KTWADEYLCV	KTWAEYLCV
SIYHTGVEL	SIYHTGVEL
GLFLTTEAVV	GLFLTTEAV
MLIEVILTA	MLIEVILTA
IISTFHLSI	IISTFHLSI
FTATSIARV	FTATSIARV
KLGIGNSPV	KLGIGNSPV
RLYDLTRYA	RLYDLTRYA
VLALYSPPL	VLALYSPPL
YISKCWDYA	YISKCWDYA
VLHSFTDAI	VLHSFTDAI
GMEAQFLYL	GMEAQFLYL
GLSSGFYFEI	GLSSFYFEI
KIFRCLTVL	KIFRCLTVL
GLFDINVIGL	GLFDNVIGL
FMFIGSPMYL	FMFISPMYL
AVITETIPI	AVITETIPI
SLADQLIHL	SLADQLIHL
SLSTFQQMWI	SLSTQQMWI
VLNETTNWL	VLNETTNWL
TLLLWISVKV	LLLWISVKV
RMAAWMRQI	RMAAWMRQI
FLHPKHWGT	FLHPKHWGT
KLYEGDLRV	KLYEGDLRV
YLLAVCGCI	YLLAVCGCI
QLDMIITAV	QLDMIITAV
FADSDGHYV	FADSDGHYV
QLFKYVPSA	QLFKYVPSA
LLNNYDVLV	LLNNYDVLV
MLYQLLEAV	MLYQLLEAV
YLANGGFLI	YLANGGFLI
SMITMSAFL	SMITMSAFL
QLANAIFKL	QLANAIFKL
FILIFNIIV	FILIFNIIV
TLIQYRQQL	TLIQYRQQL
KLHLYSHPI	KLHLYSHPI
SQGRGWFLL	SQGRGWFLL
MLLRSAIGQV	LLRSAIGQV
GLISFYNFL	GLISFYNFL
FLLSGTAIA	FLLSGTAIA
LLDDFVEII	LLDDFVEII
KTWGQYWQV	KTWGQYWQV
AITLVVISV	AITLVVISV
GILGFVFTL	GILGFVFTL
FLLLYTIIVL	FLLLYTIIV
RLNPEVSYFT	RLNPVSYFT
LLFNEKLKV	LLFNEKLKV
MLIDLGLDL	MLIDLGLDL
FLPSDFFPSV	FLPSFFPSV
MVLAFITFL	MVLAFITFL
YLKKKNHPL	YLKKKNHPL
FANSKFTLV	FANSKFTLV
ALLSCIRNA	ALLSCIRNA
GLQDCTMLV	GLQDCTMLV
LMSTLLIYL	LMSTLLIYL
TMSIYIAVA	TMSIYIAVA
TIAVITETI	TIAVITETI
KSFFWFNEV	KSFFWFNEV
KQLEYSWVL	KQLEYSWVL
MMATIGIAL	MMATIGIAL
MLTFDVFRPL	LTFDVFRPL
FIKPPLITL	FIKPPLITL
ALINDQLIM	ALINDQLIM
AIAACAMLLV	AIAAAMLLV
ALYYVHSLL	ALYYVHSLL
YLMDEEVPA	YLMDEEVPA
PLNEGIMAV	PLNEGIMAV
MMMMKWIISI	MMMKWIISI
KMMGRLADA	KMMGRLADA
TLRNTNPNFV	TLRNNPNFV
FLKMRRIFGV	FLKMRIFGV
ILDLISESPI	ILDLSESPI
WLSHDLYDYI	WLSHLYDYI
NVISKIYTLI	NVISKIYTL
SAAGIGILTV	SAAGGILTV
SLYNTIATL	SLYNTIATL
GVLIAGIILL	VLIAGIILL
LLVLQAGFFL	LVLQAGFFL
MIITAVNSLI	MIITAVNSL
VMLLVLCAV	VMLLVLCAV
MTLWYMWQV	MTLWYMWQV
MLWCKDGHV	MLWCKDGHV
FLAFLLFLVL	FLAFLLFLV
FMYTKHSMLT	FMYTKHSML
FLGAGALAV	FLGAGALAV
FIGYMVKNV	FIGYMVKNV
AQIGVIGVF	AQIGVIGVF
KLANIQCLCL	KLANQCLCL
IIFLFILLL	IIFLFILLL
ALYKGFQFI	ALYKGFQFI
VLLEKAPPL	VLLEKAPPL
FILTAILFFM	ILTAILFFM
LVWYTVFGA	LVWYTVFGA
SMYVIPDELI	SMYVIPDEL
RSLFNTVAVLY	SLFNTVAVL
LLLRQWLHV	LLLRQWLHV
KMNPPKFSKV	KMNPKFSKV
HLVDFQVTI	HLVDFQVTI
LMGHFSWWT	LMGHFSWWT
SLTNEIYASI	SLTNIYASI
ILKEPVHGV	ILKEPVHGV
HLIFSYAFL	HLIFSYAFL
VLPFDIKYI	VLPFDIKYI
QLIPCMDVV	QLIPCMDVV
LLVPFVQWFV	LLVPVQWFV
NIGAYVVLV	NIGAYVVLV
SLNARGLLV	SLNARGLLV
LLMMTLPSI	LLMMTLPSI
KLTPLCVTL	KLTPLCVTL
WAIIPLSASV	AIIPLSASV
LLSIIFFPA	LLSIIFFPA
LLYFILFFV	LLYFILFFV
NLLSKNTFYL	LLSKNTFYL
IVNSVLLFL	IVNSVLLFL
QLLEAVYGNI	LLEAVYGNI
ILDQVPFSV	ILDQVPFSV
YVIKVSARV	YVIKVSARV
ISFAISCFLL	ISFASCFLL
VLVKSPNHV	VLVKSPNHV
ILLKATLLAV	ILLKTLLAV
ILCWGELMTL	ILCWELMTL
VLAGYGAGI	VLAGYGAGI
YLALLAAFKV	YLALAAFKV
SCINRCFYV	SCINRCFYV
LMLHQQYNQ	LMLHQQYNQ
KLYTIVSTL	KLYTIVSTL
YLMCLSPLM	YLMCLSPLM
VMAGVGSPYV	VMAGGSPYV
YIFRNTINM	YIFRNTINM
VLIRRCHYL	VLIRRCHYL
RLGAIPPLV	RLGAIPPLV
GLVGLVTFLL	GLVGVTFLL
RTLLGLILFV	TLLGLILFV
YIDALAKNA	YIDALAKNA
CTVQEFIFSA	TVQEFIFSA
KLLNMRDLI	KLLNMRDLI
IISDLSIFI	IISDLSIFI
LIFFVIILA	LIFFVIILA
FLTYLDVSV	FLTYLDVSV
LISIFLHLV	LISIFLHLV
ILHNGAYSL	ILHNGAYSL
KLFFAKCLV	KLFFAKCLV
VMKLFTISV	VMKLFTISV
GLSQFTHTV	GLSQFTHTV
FLSLMSLSI	FLSLMSLSI
TLNTLITLI	TLNTLITLI
MLPESDLDKV	MLPEDLDKV
YLACLAAVI	YLACLAAVI
FTIAMWLLL	FTIAMWLLL
KLAKKVLSRV	KLAKVLSRV
WLYDLWGQL	WLYDLWGQL
LLFLGVVFL	LLFLGVVFL
GLYGAQYDV	GLYGAQYDV
FAIEALAKA	FAIEALAKA
SLIAIIKGV	SLIAIIKGV
VLDRRLHLV	VLDRRLHLV
KLMGHFSWWT	KLMGFSWWT
QLLADFPEA	QLLADFPEA
ILSNYVKTLL	ILSNYVKTL
VMVTITQNV	VMVTITQNV
FLTAALPVKL	FLTALPVKL
RILGAGCFV	RILGAGCFV
CTLNFPISPI	TLNFPISPI
KLYGYASLT	KLYGYASLT
YLVWQPMSA	YLVWQPMSA
YVVIAILTV	YVVIAILTV
LVLSVNPYV	LVLSVNPYV
FLYDRIAST	FLYDRIAST
IILFILFFA	IILFILFFA
FLHDVENFL	FLHDVENFL
MIAAYTAAL	MIAAYTAAL
SVYDFFVWL	SVYDFFVWL
KLLIAILGPL	LLIAILGPL
FLWGPRALA	FLWGPRALA
FLKDVMVEI	FLKDVMVEI
HISIKVKNHI	ISIKVKNHI
KMKKKTWLV	KMKKKTWLV
WMRLLPLLAL	WMRLPLLAL
KLLGQINLV	KLLGQINLV
LLQGVPFHV	LLQGVPFHV
FTNDVSFLA	FTNDVSFLA
YQSFLFWFL	YQSFLFWFL
QLLQANPIL	QLLQANPIL
KMIEYAKLYV	KMIEAKLYV
FMFNELLAL	FMFNELLAL
YLIKLIEPV	YLIKLIEPV
ILTREMGFLV	ILTRMGFLV
FLSNVGHYV	FLSNVGHYV
ALNHLVLSL	ALNHLVLSL
ALASCMGL	ALAS-CMGL
YIIPCILIL	YIIPCILIL
YVSPTEMVDV	YVSPEMVDV
RLHGLSAFSL	RLHGSAFSL
KLGKAGYVV	KLGKAGYVV
ELANEVKVLL	ELANVKVLL
TLTAAVLLLV	LTAAVLLLV
KMIGNHLWV	KMIGNHLWV
YLWWVNNQSL	YLWWNNQSL
ILWFFNAMVL	ILWFFNAMV
NLSNCVHPA	NLSNCVHPA
WLMWFIISIV	WLMWFIISI
KLQAAPYIV	KLQAAPYIV
GLLRVISGV	GLLRVISGV
MLNRVQILM	MLNRVQILM
AAAWYLWEV	AAAWYLWEV
YIIDWMVDI	YIIDWMVDI
RLCLDVPPV	RLCLDVPPV
GLFQFFVFLA	GLFQFFVFL
IMGVIFLISV	IMGVFLISV
FTFTIYTDEV	FTFTYTDEV
SLMDMITLSL	SLMDITLSL
SVYNTVATL	SVYNTVATL
ILTGLNYEA	ILTGLNYEA
LLALLSCLTV	LLALSCLTV
RQASLSISV	RQASLSISV
LLALQQLEV	LLALQQLEV
RMIGGIGRFYI	MIGGGRFYI
ILHEPVHGV	ILHEPVHGV
SISSVLTIL	SISSVLTIL
TIMAAILAYT	IMAAILAYT
GMLWMADVPL	MLWMADVPL
FIIFLFILLL	FIIFFILLL
RIITILQDI	RIITILQDI
YLDVDLHPA	YLDVDLHPA
GILTVILGV	GILTVILGV
ILFIMFMLI	ILFIMFMLI
YCNYTKFWYV	YCNYKFWYV
LLHGLDFSEV	LLHGDFSEV
RLEARIAQL	RLEARIAQL
RVYKTIWEI	RVYKTIWEI
MQYEVTQHA	MQYEVTQHA
VTAEHLARL	VTAEHLARL
HTICDDYFV	HTICDDYFV
KLQAAVMET	KLQAAVMET
FMQEIPTFL	FMQEIPTFL
VLLFLAFVV	VLLFLAFVV
DAMPGVLSYV	AMPGVLSYV
ALIAVSLIAA	ALIASLIAA
YLDPAQQNL	YLDPAQQNL
KLVVGAVGV	KLVVGAVGV
VLATDVTSFL	VLATVTSFL
QIITLTAFV	QIITLTAFV
ALCRWGLLL	ALCRWGLLL
NLYDDNDIRT	NLYDNDIRT
ILDNAAKYV	ILDNAAKYV
YLYLTFYFT	YLYLTFYFT
LLSAINFKI	LLSAINFKI
GLFDFVNFV	GLFDFVNFV
FVVDTTPPL	FVVDTTPPL
YMIKLAKEV	YMIKLAKEV
VMSELFDTL	VMSELFDTL
KLCSPVFAI	KLCSPVFAI
VMAVGLVSI	VMAVGLVSI
YILYIVFCI	YILYIVFCI
GLDERFVEEL	GLDEFVEEL
ALPPVAPV	ALPP-VAPV
ILYNEYNFV	ILYNEYNFV
TLLNETAKV	TLLNETAKV
GLSRYVPRL	GLSRYVPRL
LLSNTLAEL	LLSNTLAEL
YLLGDSDSV	YLLGDSDSV
YLKEYIPKA	YLKEYIPKA
FMDGKQACVL	FMDGKQACV
VLLNAPSEA	VLLNAPSEA
ILLSRCLWWT	LLSRCLWWT
ALLGGLRPV	ALLGGLRPV
FLLPDAQSI	FLLPDAQSI
ALAWSLQML	ALAWSLQML
IIDKDTNSV	IIDKDTNSV
SLYNTVVTL	SLYNTVVTL
GLMWLSYFVA	GLMWLSYFV
LLMGTLGIV	LLMGTLGIV
KLTSYSAGL	KLTSYSAGL
SIFVSTMPV	SIFVSTMPV
KLHRYIDSM	KLHRYIDSM
SMFASCNLL	SMFASCNLL
YTFTSLFSL	YTFTSLFSL
LLYAHINAL	LLYAHINAL
FVWQERAAV	FVWQERAAV
TLTAAVLMLV	LTAAVLMLV
QLYKEQLAKL	QLYKQLAKL
QLIPCMDVVL	QLIPCMDVV
YLWPGPVTA	YLWPGPVTA
IAGGVMAVV	IAGGVMAVV
FVVWALLGL	FVVWALLGL
NIISYIILFI	IISYIILFI
FILHRLHEI	FILHRLHEI
GQLASMVKL	GQLASMVKL
FLWEDQTLL	FLWEDQTLL
ALKGTNESL	ALKGTNESL
SLLTYAGPI	SLLTYAGPI
RTWCRLLQV	RTWCRLLQV
SLFIESSICL	SLFISSICL
YAMCTNTFVL	AMCTNTFVL
NLLLWPLYV	NLLLWPLYV
YLEPGPVTA	YLEPGPVTA
FMTALVLSL	FMTALVLSL
RLHGLEAFSL	RLHGEAFSL
YLVAYQATI	YLVAYQATI
QLSCISTYV	QLSCISTYV
FLWHVRKRV	FLWHVRKRV
VLFSGVSWTM	VLFSGVSWT
AMYGKHITL	AMYGKHITL
GQLFSFFEEV	QLFSFFEEV
FLEESHPGI	FLEESHPGI
ILLLDQVLV	ILLLDQVLV
YMYAVSGAL	YMYAVSGAL
VPRPCQKSL	VPRPCQKSL
FIMLEGETKL	IMLEGETKL
LLDCIMFQS	LLDCIMFQS
LMSFTILCLV	LMSFILCLV
KLLEGEESRI	KLLEEESRI
RLHKECLLRL	RLHKCLLRL
RVFNEYGFV	RVFNEYGFV
LLFFWLDRSV	LLFFLDRSV
NISLPLYTV	NISLPLYTV
ALWMRLLPLL	ALWMRLLPL
IQESFIRFTV	IQESIRFTV
GLFGAIAGFI	GLFGIAGFI
LLTACTIFYI	LLTATIFYI
VLFGLGFAI	VLFGLGFAI
YLDADREFL	YLDADREFL
FLPRVFSAV	FLPRVFSAV
HLGNVKYLV	HLGNVKYLV
VLIQRNPQL	VLIQRNPQL
SLYFGGICVI	SLYFGGICV
YLVAYQATL	YLVAYQATL
IIFWFSLEI	IIFWFSLEI
GVMYAFTTPL	VMYAFTTPL
IVMDNDDNI	IVMDNDDNI
KTFKDESIFI	KTFKESIFI
KLHCTERSL	KLHCTERSL
ILKDFSILL	ILKDFSILL
SLFNTVAVL	SLFNTVAVL
VLAAVLLGA	VLAAVLLGA
LMEVFPQLDL	LMEVPQLDL
FMASPENVI	FMASPENVI
LAERFCTEV	LAERFCTEV
NISGYNFSL	NISGYNFSL
LVIGVAFLAV	LVIGAFLAV
GLADAFILL	GLADAFILL
AIYDTMQYV	AIYDTMQYV
ALAPVFAFL	ALAPVFAFL
QLFEDNYAL	QLFEDNYAL
YTYAFTKKV	YTYAFTKKV
VLLLITHYAI	VLLLITHYA
CIDGKWNPV	CIDGKWNPV
TMTLWYMWQV	MTLWYMWQV
FLLLADARV	FLLLADARV
IAGGVCYYLL	IAGGVCYYL
IIIPFIAYFV	IIIPIAYFV
FVIFACNFV	FVIFACNFV
KIIETYLGRV	KIIEYLGRV
ILGFVFTL	ILGF-VFTL
YLSPIASPLL	YLSPASPLL
RLITVNPIV	RLITVNPIV
MLLALVALV	MLLALVALV
GIFCFRILL	GIFCFRILL
TINCDVGYEV	TINCVGYEV
TIHDIILECV	TIHDILECV
RTFLIDLAFL	RTFLDLAFL
LVIGVAFLA	LVIGVAFLA
RMWAWIHGL	RMWAWIHGL
VIHDYICWL	VIHDYICWL
KMDIGVPLL	KMDIGVPLL
ILPVIFLSI	ILPVIFLSI
FLLAQFTSAI	FLLAQFTSA
LMANLAPHLL	LMANAPHLL
FANYKFTLV	FANYKFTLV
LLVTLAILTA	LLVTAILTA
VLSPLPSQA	VLSPLPSQA
RVFKKIMSI	RVFKKIMSI
TLLGDGPVV	TLLGDGPVV
FVNYDFALV	FVNYDFALV
LLNATDIAV	LLNATDIAV
RLDARLQVL	RLDARLQVL
NLLDSYFVV	NLLDSYFVV
SLHCKPEEA	SLHCKPEEA
VLIALSVLA	VLIALSVLA
RLVDGVGGI	RLVDGVGGI
YLDAYNMMI	YLDAYNMMI
QMTSTFIML	QMTSTFIML
ALIGTMCGIL	ALIGTMCGI
FMIDWILDA	FMIDWILDA
VVMACLVPAA	VMACLVPAA
CQLAKTCPV	CQLAKTCPV
GIVSGILLSI	IVSGILLSI
FANNEFTLV	FANNEFTLV
IMIGVLVGVA	IMIGVLVGV
LLMLLPTAL	LLMLLPTAL
ITDQVPFSV	ITDQVPFSV
FVVYNLTGV	FVVYNLTGV
ALYWALMES	ALYWALMES
ATYGIIVPV	ATYGIIVPV
IAATYNFAV	IAATYNFAV
FTLGIMAIA	FTLGIMAIA
VMISILNPV	VMISILNPV
MLHNPTSETM	MLHNPTSET
IIMDEAHFL	IIMDEAHFL
GIYHDICEI	GIYHDICEI
KSLFNTIAVLY	SLFNTIAVL
WVLAYMLFT	WVLAYMLFT
LLWQDPVPA	LLWQDPVPA
ALLSRFFNM	ALLSRFFNM
VLLGGVGLVL	VLLGGVGLV
LILSLTCSV	LILSLTCSV
KLLEGEEERL	KLLEEEERL
ALMPLYACI	ALMPLYACI
VLAGIFAGV	VLAGIFAGV
LMGHFSWWTA	LMGHSWWTA
VLITWLIDYV	VLITLIDYV
YLEFEALGFL	YLEFALGFL
LNTVATLY	LNTV-ATLY
YLISIFLHL	YLISIFLHL
YLYALYSPL	YLYALYSPL
ALAKAAAAL	ALAKAAAAL
YTYFSNTILL	YTYFNTILL
VLDQLRCNGV	VLDQRCNGV
GLYLYRFHV	GLYLYRFHV
GMMMGMFNML	MMMGMFNML
FIYGYLEPV	FIYGYLEPV
SLVNGVVRL	SLVNGVVRL
GLLPLFLLLG	GLLPLFLLL
KLNDWDFVV	KLNDWDFVV
GMLFVNDLM	GMLFVNDLM
LILSCIFAFI	ILSCIFAFI
ALFEDYPGC	ALFEDYPGC
VIACLLVAV	VIACLLVAV
GLTSAVIDA	GLTSAVIDA
LLIAILGPL	LLIAILGPL
LLPDALLFTL	LLPDLLFTL
KMIGGIGGFI	KMIGIGGFI
RTNDWDFVV	RTNDWDFVV
LLGICLTSTV	LLGILTSTV
LLFKTSAGV	LLFKTSAGV
GLVFRFSEV	GLVFRFSEV
FLNPVIYTF	FLNPVIYTF
ATQPVHWFL	ATQPVHWFL
ALAEHISDSI	ALAEISDSI
KMEKASFIEV	KMEKSFIEV
KLESMGIYQI	KLESGIYQI
KLADMSIYC	KLADMSIYC
LLIKTLSPA	LLIKTLSPA
WYYDFHFFV	WYYDFHFFV
FLATCVNGV	FLATCVNGV
FLPSDFFPS	FLPSDFFPS
MMNITRLEVI	MMNITRLEV
KLAGGVAVL	KLAGGVAVL
LLWFLTGTFV	LLWFTGTFV
ALTIACMTV	ALTIACMTV
RQASIELPSM	RQASELPSM
HLYQGCQV	HLYQ-GCQV
GLVSFNFLV	GLVSFNFLV
QLLSAVDYI	QLLSAVDYI
WVFPESISPV	WVFPSISPV
FLPKDYFPSV	FLPKYFPSV
NLDLFMSHV	NLDLFMSHV
LTFWQIDYL	LTFWQIDYL
YLYVHSPAL	YLYVHSPAL
KQLNYCHLI	KQLNYCHLI
YLYTEYFLFL	YLYTYFLFL
RLLQSFLKV	RLLQSFLKV
KLGEGFKSL	KLGEGFKSL
ILLEPVHGV	ILLEPVHGV
KLMPGSIYV	KLMPGSIYV
CLTSTVQLV	CLTSTVQLV
AMLHWSLIL	AMLHWSLIL
FLSPNQVTNV	FLSPQVTNV
LLIEGIFFI	LLIEGIFFI
MLDDFSAGA	MLDDFSAGA
HLYQGCQVV	HLYQGCQVV
LVFGIELMEV	LVFGELMEV
MVISLLSMI	MVISLLSMI
FLFAVGFYL	FLFAVGFYL
FLYPSWSLY	FLYPSWSLY
LLFDSNEPI	LLFDSNEPI
TMPELAWAV	TMPELAWAV
KVADVDLAVPV	KVADVDLAV
YLVAYQKTV	YLVAYQKTV
RLFTRCAVI	RLFTRCAVI
FVNDLMTMNI	FVNDMTMNI
LLGLWGLTGL	LLGLGLTGL
KVTAASPML	KVTAASPML
ILDNLRCHSA	ILDNRCHSA
ITSYKFESV	ITSYKFESV
IMFMLIFNV	IMFMLIFNV
YLSAKITTL	YLSAKITTL
FTAKINEMV	FTAKINEMV
RLFSYNFTT	RLFSYNFTT
KMCTVSDYI	KMCTVSDYI
SLIDLLHKI	SLIDLLHKI
MQFDKVYLST	MQFDVYLST
MITMSAFLIV	ITMSAFLIV
ALCRWGLLLA	ALCRWGLLL
KTDGIPITI	KTDGIPITI
FLHEDTEKI	FLHEDTEKI
SMINGVVKL	SMINGVVKL
YLVTRHADV	YLVTRHADV
GLDTYVRSL	GLDTYVRSL
KMMLFYMDL	KMMLFYMDL
RVIEVLQRA	RVIEVLQRA
VLSYVIGLL	VLSYVIGLL
LLGQVQTYV	LLGQVQTYV
VMDTLNGIMM	VMDTLNGIM
GLLEWIFRA	GLLEWIFRA
AMPGVLSYV	AMPGVLSYV
WMMAMKYPITA	MMAMYPITA
IVFNLPVSKV	IVFNPVSKV
FLAFLLFLV	FLAFLLFLV
FLLPLTSLVI	FLLPLTSLV
ILEYLYIMRV	ILEYYIMRV
VLPPEINSL	VLPPEINSL
KLQWLFAAL	KLQWLFAAL
GTLGIVCPI	GTLGIVCPI
YIFATCLGL	YIFATCLGL
VLLLVTHYAI	VLLLVTHYA
ILALFLAHYI	ILALLAHYI
LLLEWLAEVV	LLLEWLAEV
VLDTTLYAV	VLDTTLYAV
FMFNDLLKL	FMFNDLLKL
SLCLMMILPA	SLCLMILPA
YQCGHYTHI	YQCGHYTHI
SLTPSPLDL	SLTPSPLDL
LIMIYFFII	LIMIYFFII
FLTGTFVTA	FLTGTFVTA
TISGNIYSA	TISGNIYSA
FLMSFTILCL	FLMSTILCL
YLVNAIIDSA	YLVNIIDSA
FVDGVPFVV	FVDGVPFVV
SMTECSQEL	SMTECSQEL
FIDSYICQV	FIDSYICQV
SLNSMYTRL	SLNSMYTRL
LIVILFIMFM	IVILFIMFM
ILFLTLIVFT	ILFLLIVFT
TVIKTLLEV	TVIKTLLEV
MLCGFSPAL	MLCGFSPAL
FLEQGGFKA	FLEQGGFKA
AVYNFATCGI	AVYNATCGI
SLYNSVATL	SLYNSVATL
LLFRFMRPLI	LLFRFMRPL
SVMNFIPII	SVMNFIPII
CLDAGINYV	CLDAGINYV
YLATGALLA	YLATGALLA
TALLSCIRNA	ALLSCIRNA
ILTDGPERV	ILTDGPERV
SLTTISTTL	SLTTISTTL
FVTIYSHLL	FVTIYSHLL
IMETIDPVYI	IMETDPVYI
KLVGKLNWA	KLVGKLNWA
SLYQTVATL	SLYQTVATL
VMAWRTIMAV	VMAWTIMAV
KFLDWMIFI	KFLDWMIFI
LLCLIFLLV	LLCLIFLLV
YMPTVIEEL	YMPTVIEEL
DLAEWVPRV	DLAEWVPRV
QLFPGLAAL	QLFPGLAAL
YVPGYSITT	YVPGYSITT
KLIEPVNAI	KLIEPVNAI
WLLLRQLPI	WLLLRQLPI
LLCLIFLLVL	LLCLIFLLV
KLSDVGHQYA	KLSDGHQYA
FMVYVPLPA	FMVYVPLPA
LLIDLTSFL	LLIDLTSFL
SLNLRETNL	SLNLRETNL
FANYNFTLV	FANYNFTLV
RLIVFPDLGV	RLIVPDLGV
YMDDVVLGV	YMDDVVLGV
VVHGYFTEV	VVHGYFTEV
GLHAAAPHL	GLHAAAPHL
LWMRLLPLL	LWMRLLPLL
KSLFNTVAVL	SLFNTVAVL
YLDFLLLLL	YLDFLLLLL
ALSPALTAL	ALSPALTAL
YQTYTEWSV	YQTYTEWSV
LLFRFMRPL	LLFRFMRPL
YMDLSYHGVT	YMDLSYHGV
RMMGVKYLM	RMMGVKYLM
LTFNFTPKI	LTFNFTPKI
KLYLVDYGL	KLYLVDYGL
KLPQLCTEL	KLPQLCTEL
FLPWHRLFLL	FLPWRLFLL
GLSDRVVFV	GLSDRVVFV
ILLAPLLSA	ILLAPLLSA
FLPSDFFPSA	FLPSFFPSA
YLVKYQATV	YLVKYQATV
LAALFMYYA	LAALFMYYA
NMQTVKLFV	NMQTVKLFV
STITNEFCV	STITNEFCV
GMGWLTIGI	GMGWLTIGI
YLSGTDDEV	YLSGTDDEV
YADHGANQL	YADHGANQL
RLASSVFDL	RLASSVFDL
LLATVFKLTA	LLATFKLTA
YQVAYQATV	YQVAYQATV
RLVDAMVYT	RLVDAMVYT
KSLYNTVAVL	SLYNTVAVL
YLLDRGADI	YLLDRGADI
FLPSDYKPSV	FLPSYKPSV
YITALNHLVL	YITALNHLV
NMISDTIFV	NMISDTIFV
AIMESDSFL	AIMESDSFL
LMMSCISCI	LMMSCISCI
TLLCVLAAL	TLLCVLAAL
TMLSIILVII	TMLSIILVI
LVFLWLLWPV	LVFLLLWPV
WLLQITVLL	WLLQITVLL
ARWLFPVYL	ARWLFPVYL
LLLTLLATV	LLLTLLATV
ALDEGLLPV	ALDEGLLPV
LITWLIDYV	LITWLIDYV
DLADQLIHL	DLADQLIHL
RLYPDAPPL	RLYPDAPPL
FVNYDFTIV	FVNYDFTIV
LVFIKPPLI	LVFIKPPLI
RSLYNTIAVL	SLYNTIAVL
YVSSIFLHL	YVSSIFLHL
FLLALLSCI	FLLALLSCI
YTYSGLFCVV	YTYSGLFCV
MITMSAFLI	MITMSAFLI
KIMSIGFEA	KIMSIGFEA
LLDLFGPEV	LLDLFGPEV
TMGPHPAGV	TMGPHPAGV
FLADAVVRL	FLADAVVRL
FLPSKYFPSV	FLPSYFPSV
RLPRYLACL	RLPRYLACL
TIAHINTLI	TIAHINTLI
FLRGEAILQI	FLRGAILQI
TIIALLFAL	TIIALLFAL
LLTYFCFVA	LLTYFCFVA
GLAAAVVAV	GLAAAVVAV
KTWFLVPLI	KTWFLVPLI
TLVKSGLTEV	TLVKGLTEV
GLAGLQTDV	GLAGLQTDV
VLFSGPSPL	VLFSGPSPL
RLIGHISTL	RLIGHISTL
QLFMHTMFIL	QLFMHTMFI
VLMEWLKTRPI	VLMEWLKTR
MLYPLLWMF	MLYPLLWMF
YQLAVTIMA	YQLAVTIMA
YLDLALMSV	YLDLALMSV
KLFTDNNFL	KLFTDNNFL
FMGVIYIMI	FMGVIYIMI
FIPSYDFPSV	FIPSDFPSV
LNMETLNMTM	NMETLNMTM
AMLQLDPNA	AMLQLDPNA
GIRPYEILA	GIRPYEILA
ALKEAIEMV	ALKEAIEMV
GTDGFPFKL	GTDGFPFKL
YILHSDYQL	YILHSDYQL
TLARGFPFV	TLARGFPFV
MMQVWIQPL	MMQVWIQPL
FLCLLMKLSI	FLCLMKLSI
VLLGVKLSGV	VLLGKLSGV
KIFEYGFTF	KIFEYGFTF
YNIDRLNAL	YNIDRLNAL
FIASNGVKLV	FIASGVKLV
IVLEFFMMV	IVLEFFMMV
YTIERIFNA	YTIERIFNA
RLRQDTEDI	RLRQDTEDI
FLQISRVNDL	FLQIRVNDL
YIFSYDAYT	YIFSYDAYT
RLLPLWAALPL	RLLPLWAAL
RLVDFFPDI	RLVDFFPDI
FLVIAINAM	FLVIAINAM
TLGVYDYLV	TLGVYDYLV
YLISIFLHLV	YLISFLHLV
GLAGTVLRFV	GLAGVLRFV
FLEFEALGFL	FLEFALGFL
SIISLFYTFA	SIISFYTFA
ILYDNVVTL	ILYDNVVTL
ALALEQYGI	ALALEQYGI
TLNTLITLIL	TLNTLITLI
RMGAVTTEV	RMGAVTTEV
MVIACLLVA	MVIACLLVA
FLLFLVLIML	FLLFVLIML
FLLIRYITT	FLLIRYITT
FLYGALRLA	FLYGALRLA
FLLSLGIHL	FLLSLGIHL
GMRDVSFEL	GMRDVSFEL
MMKTYIEFV	MMKTYIEFV
FIALNLSFI	FIALNLSFI
ITMTTVYHI	ITMTTVYHI
TMFGGVSWMI	TMFGVSWMI
YVASYLLAA	YVASYLLAA
VLAALVCYIV	VLAALVCYI
FLAGHPLTNL	FLAGPLTNL
KLWASFFQG	KLWASFFQG
RLMKQDFSV	RLMKQDFSV
TILATLNTLI	ILATLNTLI
SYMMDDLELI	YMMDDLELI
VLKEGSEYRV	VLKESEYRV
LQYDLWNVV	LQYDLWNVV
FLAFVVFLLV	FLAFVVFLL
YLVAYQATV	YLVAYQATV
IMSSSLFNL	IMSSSLFNL
HLSCKSGFTL	HLSCSGFTL
VLADDLLEA	VLADDLLEA
FMMVLLIPEP	FMMVLIPEP
CLMMMLPATL	LMMMLPATL
MASDFNLPPV	MASDNLPPV
TILATLNTL	TILATLNTL
QLAKLMATL	QLAKLMATL
SLYNTIATLY	SLYNTIATL
ILSPPINAPI	ILSPINAPI
IIMAINVFT	IIMAINVFT
SLYNTIAVL	SLYNTIAVL
VLNPYMPTV	VLNPYMPTV
QLVWENFLA	QLVWENFLA
FLARAIVFV	FLARAIVFV
ILYLYETYHL	ILYLETYHL
VLAGWLFHV	VLAGWLFHV
ILAQVPFSV	ILAQVPFSV
KLLISKGIEI	LLISKGIEI
LLDKQQFEL	LLDKQQFEL
FLADKKMTL	FLADKKMTL
FVYTPSPYV	FVYTPSPYV
QLLDPPAAV	QLLDPPAAV
SMIGLCACV	SMIGLCACV
VLVVQPAPV	VLVVQPAPV
KLPTWLGAAI	KLPTLGAAI
IILAISALL	IILAISALL
SLYKGVYEL	SLYKGVYEL
KMLMTGTLAV	MLMTGTLAV
LTIMGVIFLI	TIMGVIFLI
RLNKVISEL	RLNKVISEL
YLLPRRGPRL	LLPRRGPRL
YLYGIGSAV	YLYGIGSAV
LLFLVCFPST	LLFLCFPST
TLIDIWFLA	TLIDIWFLA
MVNTVLITV	MVNTVLITV
TLVDICFWS	TLVDICFWS
SLNLTIVSV	SLNLTIVSV
SLYADSPSV	SLYADSPSV
DMYDQQLSV	DMYDQQLSV
SLVEMMWDL	SLVEMMWDL
ALTDVEKRIL	ALTDVEKRI
RALKAYFTA	RALKAYFTA
GIVCYNEEV	GIVCYNEEV
GLIYTYSGL	GLIYTYSGL
SLEYGANYFL	SLEYANYFL
KLWAQCVQL	KLWAQCVQL
MLDLQPETT	MLDLQPETT
SLVTGFINFI	SLVTFINFI
NIGCAVNTPV	NIGCVNTPV
KLYLVDYGLV	KLYLVDYGL
LVLGIALLYI	LVLGALLYI
FVGALSFSI	FVGALSFSI
AIYGRPVSA	AIYGRPVSA
YLYGLSPAI	YLYGLSPAI
FADTVVACV	FADTVVACV
LLLCLIFLLV	LLLCLIFLL
KLFFAKCLVV	KLFFAKCLV
ILISLINSLV	ILISLINSL
VILFIMFML	VILFIMFML
RLNNRPIAV	RLNNRPIAV
FMRFFTLGSI	FMRFTLGSI
MLLVHYAII	MLLVHYAII
LIMYSVIGV	LIMYSVIGV
ILIGVVITWI	ILIGVITWI
EVGIKSVVV	EVGIKSVVV
ATLGTVILL	ATLGTVILL
IVLSHILPL	IVLSHILPL
FLPSDYFPSL	FLPSYFPSL
LIQEIVHEV	LIQEIVHEV
KTMAVTYEL	KTMAVTYEL
AQFAPSASA	AQFAPSASA
SALMTLDDLA	ALMTLDDLA
TQWSLFFFV	TQWSLFFFV
SLTEILKGGV	SLTELKGGV
LMMTLPSIFL	LMMTPSIFL
YLFNAIETM	YLFNAIETM
WLSLLVPFV	WLSLLVPFV
KLVALGVNAV	KLVAGVNAV
YFSDVSAPV	YFSDVSAPV
FLTNKLLLFA	FLTNLLLFA
RLTGVTSLV	RLTGVTSLV
MTNNPPIPV	MTNNPPIPV
YLSPGPVTV	YLSPGPVTV
VTTEVAFGL	VTTEVAFGL
ITMGMPYAV	ITMGMPYAV
TLLGCWSFVL	TLLGCWSFV
KLDYWSFQL	KLDYWSFQL
CLINDPWVL	CLINDPWVL
FVIGGMTGV	FVIGGMTGV
SIILEFFLMV	IILEFFLMV
LLFGYPVYV	LLFGYPVYV
VLIALSVLAV	VLIASVLAV
VLNIVLFIL	VLNIVLFIL
ILFILFFAYV	ILFIFFAYV
TVIEGLDKL	TVIEGLDKL
FLNISWFYI	FLNISWFYI
TQFAGVVTV	TQFAGVVTV
GLWLSVAAV	GLWLSVAAV
ALIAVSIISI	ALIASIISI
RLCAYCCNI	RLCAYCCNI
FTINIAAYL	FTINIAAYL
SLCPIRGWAI	SLCPRGWAI
FVDYNFSLV	FVDYNFSLV
FLIVLSVAL	FLIVLSVAL
KLPTLFGRGV	KLPTFGRGV
FANNKFTLV	FANNKFTLV
SLYASSPGGV	SLYASPGGV
FIAEIDHWI	FIAEIDHWI
ILSAVAIFCI	ILSAAIFCI
IAVITETIPI	AVITETIPI
VLLRALPVL	VLLRALPVL
WMMWYWGPSL	MMWYWGPSL
ILGILYLYET	ILGIYLYET
LLSEIRFYI	LLSEIRFYI
SLLFKTSAGV	LLFKTSAGV
IPDGWWWAI	IPDGWWWAI
YLSEEMMEL	YLSEEMMEL
LTDHPLFPV	LTDHPLFPV
LLLENKSLTI	LLLEKSLTI
FLPSDYFKSV	FLPSYFKSV
ILLLCLIFL	ILLLCLIFL
LLFDRDTFYI	LLFDDTFYI
WLGAAITLVV	WLGAAITLV
PVLMFLLFYV	VLMFLLFYV
AITLVVISVI	AITLVVISV
YMLVLAEALI	YMLVLAEAL
FLHESDPMV	FLHESDPMV
YLVSSLSEI	YLVSSLSEI
MLPKQDIVGL	MLPKDIVGL
FLIPKGFYA	FLIPKGFYA
LVLNMVYSI	LVLNMVYSI
MINKLYGYA	MINKLYGYA
SIMAFILGII	SIMAFILGI
VMLDWGIEL	VMLDWGIEL
FLCKQYLNL	FLCKQYLNL
GLLPLLLLLL	GLLPLLLLL
AVIDAYTEI	AVIDAYTEI
QLAKAIITPV	QLAKIITPV
YVHEGVSYEV	YVHEVSYEV
YIYGIPLSL	YIYGIPLSL
REFEAQNVP	REFEAQNVP
LLDYQGMLPV	LLDYGMLPV
LLSLLVIWIL	LLSLVIWIL
GLDLENLYAV	GLDLNLYAV
RLIVLFEVFV	RLIVFEVFV
FIISVISLV	FIISVISLV
SLADTNSLA	SLADTNSLA
NVIGLIVIL	NVIGLIVIL
YVNHTGFNV	YVNHTGFNV
YIIRVTTEL	YIIRVTTEL
VMYAFTTPL	VMYAFTTPL
TLYCVHQEI	TLYCVHQEI
SLEEEIRFL	SLEEEIRFL
LLLSICLGSL	LLLSCLGSL
NMCNSDVSV	NMCNSDVSV
KTISVVTLL	KTISVVTLL
LTSLGLLYTV	LTSLLLYTV
LVLGTLEEV	LVLGTLEEV
LLLAGTPAV	LLLAGTPAV
ILTILTIIGL	ILTITIIGL
LLAGLVSLL	LLAGLVSLL
RMYSPISIL	RMYSPISIL
MLWMADVPL	MLWMADVPL
YLMPGPVTV	YLMPGPVTV
RSLYNTVATLY	SLYNTVATL
LLYSDDALHL	LLYSDALHL
ILDAARPAV	ILDAARPAV
VIIAALVLV	VIIAALVLV
TIILNKIVQL	IILNKIVQL
LLTGGAMLFL	LLTGAMLFL
ILSTLPETTV	ILSTPETTV
LLLLLFHSYA	LLLLFHSYA
SLSTKLKQV	SLSTKLKQV
FMQPDNANL	FMQPDNANL
FTMRLLSPV	FTMRLLSPV
ALVLLILMTA	ALVLILMTA
FVATFRDMLL	FVATRDMLL
SMVISLLSMI	SMVISLLSM
KTMAMVLSI	KTMAMVLSI
YLSDSDNIKI	YLSDDNIKI
AVIGALLAV	AVIGALLAV
TMLSIILVI	TMLSIILVI
LLNETAKVI	LLNETAKVI
YLWWVNGQSL	YLWWNGQSL
VLKAGQTVTI	VLKAQTVTI
LLMNELLRV	LLMNELLRV
KMVGTVQRV	KMVGTVQRV
ALAAATPMV	ALAAATPMV
KVTRFYFNM	KVTRFYFNM
IIITVGMLI	IIITVGMLI
YAIDLPVSV	YAIDLPVSV
YMWLGARYL	YMWLGARYL
GLWVCATSL	GLWVCATSL
SIISAVVGI	SIISAVVGI
FVIVIYIFTV	FVIVYIFTV
SIFERIREA	SIFERIREA
FLYGALLLA	FLYGALLLA
KLWVTVYYGV	KLWVVYYGV
RVFGLLLLGL	RVFGLLLGL
FLARSALIL	FLARSALIL
VLANFCSAL	VLANFCSAL
AMTHLSPAL	AMTHLSPAL
LIMEFNSLL	LIMEFNSLL
VLMLVAHYAI	VLMLVAHYA
AMLKSKNINI	MLKSKNINI
TINNLKMML	TINNLKMML
VIPDELIDV	VIPDELIDV
VLLLVTHYA	VLLLVTHYA
FMECNLNEL	FMECNLNEL
SQIFNIISYI	QIFNIISYI
SVMDPLIYA	SVMDPLIYA
YIMRVMANNV	YIMRMANNV
GMAEDLQSL	GMAEDLQSL
RLITANPVV	RLITANPVV
GLTDLGLLYT	GLTDGLLYT
SLYNTVSTL	SLYNTVSTL
NLSNCVHPAV	NLSNVHPAV
RSLYNTIAVLY	SLYNTIAVL
RMRGTFSAPL	RMRGFSAPL
YLIHDNIMYT	YLIHNIMYT
AVNEEWLTAV	AVNEWLTAV
KLWGLVDFV	KLWGLVDFV
FQQPQFQYL	FQQPQFQYL
GLDVKNVQLV	GLDVKNVQL
SLFDVGKFT	SLFDVGKFT
DLLSYYVVYV	LLSYYVVYV
VTLLCVLPA	VTLLCVLPA
FTPSDYFPSV	FTPSYFPSV
FLWLLWPVTL	FLWLWPVTL
MLFTKFFYL	MLFTKFFYL
FAASANFFL	FAASANFFL
NIVWEKKSLV	IVWEKKSLV
ALLTGSYTI	ALLTGSYTI
SMSQELAELL	SMSQELAEL
HLGYIIRYPV	HLGYIRYPV
WSYNAELLVA	WSYNAELLV
FLQDESAYV	FLQDESAYV
EMVELRILL	EMVELRILL
YQNEVTPEYI	YQNETPEYI
KVDDTFYYV	KVDDTFYYV
FLEQQNKIL	FLEQQNKIL
VISKIYTLI	VISKIYTLI
KIFMLVTAVV	KIFMLVTAV
LMYDIINSV	LMYDIINSV
GMSRIGMEV	GMSRIGMEV
VLLLTIGLSL	LLLTIGLSL
FLGMESCGI	FLGMESCGI
LILFLLFVCI	ILFLLFVCI
GLTADARLL	GLTADARLL
KLTFLDVEV	KLTFLDVEV
FVDEFYAYL	FVDEFYAYL
AQMGTLLIA	AQMGTLLIA
IIITCCLLSV	IITCCLLSV
VLYCVHQRV	VLYCVHQRV
KQYDSTDFKM	KQYDTDFKM
GLYSLPHDL	GLYSLPHDL
GLLGWSPQA	GLLGWSPQA
TISGVLWQV	TISGVLWQV
AVLLTYFCFV	VLLTYFCFV
RLDAEYWSV	RLDAEYWSV
WISDNTHIYL	WISDTHIYL
NLDTSPFFV	NLDTSPFFV
RLNDFLGLL	RLNDFLGLL
HMTEVVRHC	HMTEVVRHC
KMAVEVGSI	KMAVEVGSI
CMLDGGNML	CMLDGGNML
LLLDDLLVSI	LLLDLLVSI
KMVEIPFNV	KMVEIPFNV
GILSNYVKTL	ILSNYVKTL
YIFAALGGSV	YIFALGGSV
GLYPLAIPV	GLYPLAIPV
KLYERNTAF	KLYERNTAF
SMYGKAFNHA	SMYGAFNHA
SIMAFILGI	SIMAFILGI
LLGLWGTAAL	LLGLGTAAL
LVDAIDNIV	LVDAIDNIV
SVRDRLARL	SVRDRLARL
KIILFLTLI	KIILFLTLI
RLPSETFPNV	RLPSTFPNV
MIDDSIEGI	MIDDSIEGI
LVISGVFPV	LVISGVFPV
NLVPMVATV	NLVPMVATV
LLFGAPVYV	LLFGAPVYV
IVAALVFLI	IVAALVFLI
SQMETDFLEL	SQMEDFLEL
IMYTYFSNT	IMYTYFSNT
IIFILLMLV	IIFILLMLV
YLEPGPVTV	YLEPGPVTV
VLMDGHTGM	VLMDGHTGM
YVNGVVVATV	YVNGVVATV
FQWHEAMFL	FQWHEAMFL
RLYEWQHVS	RLYEWQHVS
LLSKNTFYL	LLSKNTFYL
RVLYDEFVTI	VLYDEFVTI
SLDDYNHLV	SLDDYNHLV
ILSNYVKTL	ILSNYVKTL
ALMGAVTSL	ALMGAVTSL
FANDKFTLV	FANDKFTLV
FISPASISSV	FISPSISSV
SLDSWWTSV	SLDSWWTSV
LMLLALIAVL	MLLALIAVL
AIIDYIAYM	AIIDYIAYM
ILGGWVAAQL	ILGGVAAQL
FMIVSISLV	FMIVSISLV
TQIFEVYWYL	QIFEVYWYL
DIIDFLEGA	DIIDFLEGA
GMSIVCIVAA	GMSIVCIVA
SLLEIGEGVV	SLLEIGEGV
CVLPAVVYST	VLPAVVYST
RLFDFNKQA	RLFDFNKQA
AVLAFVALI	AVLAFVALI
YLFRIVSTV	YLFRIVSTV
RLDCWRGGQV	RLDCRGGQV
VVPSYIPLV	VVPSYIPLV
LMDCIIFES	LMDCIIFES
FTIGNMFSL	FTIGNMFSL
FQYLLPGFVL	FQYLLPGFV
ALFSGVSWV	ALFSGVSWV
LLFLAFVVFL	LLFLFVVFL
KLLWFLTGT	KLLWFLTGT
YITALNHLV	YITALNHLV
HIAGSLAVV	HIAGSLAVV
LIVNSVLLFL	IVNSVLLFL
DLLFNEKLKV	LLFNEKLKV
LLDSGTTSI	LLDSGTTSI
YLPKQPEGV	YLPKQPEGV
KLVAYQATV	KLVAYQATV
KLFMALVAFL	KLFMLVAFL
GLYSSTVPV	GLYSSTVPV
RTCSNWVPL	RTCSNWVPL
SLYAVSPSV	SLYAVSPSV
RLAEPLMDL	RLAEPLMDL
KINEMVDEL	KINEMVDEL
LLQDSVDFSL	LLQDVDFSL
VLPAVVYST	VLPAVVYST
RLPPHTQPV	RLPPHTQPV
HMMVIFRLM	HMMVIFRLM
FVASFRLFA	FVASFRLFA
LLMLLPTALA	LLMLLPTAL
ITMQVPFSV	ITMQVPFSV
ALSNGIPPV	ALSNGIPPV
ALMTLDDLAI	ALMTDDLAI
KIDYYIPYV	KIDYYIPYV
FLPNDFFPSA	FLPNFFPSA
IIFGESSIFV	IIFGSSIFV
AAAKAAAAV	AAAKAAAAV
FMAYTTSHI	FMAYTTSHI
YAAEMVEYL	YAAEMVEYL
KSGLFQFFV	KSGLFQFFV
YLALIATFKI	YLALATFKI
AIYVFCISL	AIYVFCISL
RLPLVLPAV	RLPLVLPAV
FLFLAWIMLL	FLFLWIMLL
YLFDYPHFEA	YLFDPHFEA
ILLSIARVV	ILLSIARVV
VMLIGIEIL	VMLIGIEIL
QMIYSAARV	QMIYSAARV
KLIDRTESL	KLIDRTESL
TLATGPILTL	TLATPILTL
HVDGKILFV	HVDGKILFV
ILLFVIVIYI	LLFVIVIYI
AVLADFSLV	AVLADFSLV
FMDGKQACV	FMDGKQACV
KLQEMEGTV	KLQEMEGTV
LMAAILAYT	LMAAILAYT
LVMDKNHAI	LVMDKNHAI
YLVAYQAKV	YLVAYQAKV
LVGPTPVNI	LVGPTPVNI
TVQEFIFSAL	TVQEFIFSA
HLFIYATCLGL	FIYATCLGL
SLIYYQNEV	SLIYYQNEV
YQYGDNLIL	YQYGDNLIL
ILMIFISSFL	ILMIISSFL
FVNHRFTLV	FVNHRFTLV
RLDSYVRSL	RLDSYVRSL
TLFLILCYFI	TLFLLCYFI
YAMCTNTFV	YAMCTNTFV
IMLNGIMYRL	MLNGIMYRL
RLLEVMDSL	RLLEVMDSL
SLYNTVAVL	SLYNTVAVL
LMLPGMNGI	LMLPGMNGI
VLFDDLCEA	VLFDDLCEA
FAFKDLFVV	FAFKDLFVV
GLNLVVSSSV	GLNLVSSSV
MLYVIFPGT	MLYVIFPGT
MMMNWSPTTA	MMMNSPTTA
GLWAIKSVL	GLWAIKSVL
GLLCLTLFV	GLLCLTLFV
SLVGFGILCV	SLVGGILCV
LVASLNPNM	LVASLNPNM
SMITMSAFLI	SMITMSAFL
ILLLCLIFLL	LLLCLIFLL
LLSAGIFGA	LLSAGIFGA
SLYNTVAVLY	SLYNTVAVL
FMQALHLLL	FMQALHLLL
GMPEGDLVYV	GMPEDLVYV
VLLPSLFLLL	VLLPSLFLL
ALTIMGVIFL	ALTIGVIFL
NLYRIGQSKV	NLYRGQSKV
YLYGIGSAVV	YLYGIGSAV
LMTAISQGI	LMTAISQGI
RLDKVEAEV	RLDKVEAEV
KLMPICMDV	KLMPICMDV
QTCAGVIEYA	TCAGVIEYA
GLFGGLNWI	GLFGGLNWI
TLAPFNFLV	TLAPFNFLV
SQDEVLFLV	SQDEVLFLV
VIDEILFKV	VIDEILFKV
KLLKMVTSV	KLLKMVTSV
KSSFFVWVI	KSSFFVWVI
CAPHRVSGV	CAPHRVSGV
LLQFIVFLL	LLQFIVFLL
YLLFNHFSV	YLLFNHFSV
LLAQFTSAI	LLAQFTSAI
MLVSQALNSV	LVSQALNSV
ALVSDCAST	ALVSDCAST
LIANIFTPLV	LIANFTPLV
ILVGYMSNL	ILVGYMSNL
FIAPLGFSL	FIAPLGFSL
VLHDDLLEA	VLHDDLLEA
ALLSCLTTPA	LLSCLTTPA
RMLGDVMAV	RMLGDVMAV
IISSKQYPA	IISSKQYPA
NMDWRSLTQV	NMDWSLTQV
ALAETSYVKV	ALAESYVKV
KLLNMRDLIV	KLLNRDLIV
ELYNKPLYEV	ELYNPLYEV
KIWMAPSLT	KIWMAPSLT
LLNATDIAVA	LLNATDIAV
DASLMDMITL	ASLMDMITL
WVNCSSMTFL	WVNCSMTFL
RTAWWVWCV	RTAWWVWCV
MMCPFLFLM	MMCPFLFLM
AMALIGDSTV	AMALGDSTV
YLMCLSPLMA	YLMCLSPLM
QLQCHQIAI	QLQCHQIAI
ALYLLDGLRA	ALYLDGLRA
ALVREGLRNV	ALVRGLRNV
ILLAELEQL	ILLAELEQL
WLMKNMDPL	WLMKNMDPL
ITFQVPFSV	ITFQVPFSV
RTNDLTALL	RTNDLTALL
LLPPQHLIRV	LLPPHLIRV
IIAIVFVFI	IIAIVFVFI
RTFSPTYGL	RTFSPTYGL
VLAALVCYI	VLAALVCYI
LMDMITLSL	LMDMITLSL
RLAVYIDKV	RLAVYIDKV
YIIKNTFNV	YIIKNTFNV
FQLIFFLTLA	FQLIFFLTL
ALMAITKNV	ALMAITKNV
SVSDFDLRI	SVSDFDLRI
NLFDIPLLTV	NLFDPLLTV
VVFVVFMGV	VVFVVFMGV
FLMQIAILV	FLMQIAILV
SMAMTCIAV	SMAMTCIAV
CVLTTIDGV	CVLTTIDGV
ISDPLTSGL	ISDPLTSGL
AILGVLATL	AILGVLATL
VLMIKALEL	VLMIKALEL
SMSQELAEL	SMSQELAEL
NMLSTVLGV	NMLSTVLGV
KMNNDVFFM	KMNNDVFFM
RLLGTFTWT	RLLGTFTWT
IVYGRSNAI	IVYGRSNAI
MSDWGHITV	MSDWGHITV
YLSDSAINI	YLSDSAINI
ALLPLSLLFL	ALLPSLLFL
FLWSVFMLI	FLWSVFMLI
KSLFNTVAVLY	SLFNTVAVL
SLPSYAAYA	SLPSYAAYA
YMMDGNECP	YMMDGNECP
SIIDPLIYA	SIIDPLIYA
FVANFSMEL	FVANFSMEL
LLQLTVWGI	LLQLTVWGI
RQMATTTNPL	QMATTTNPL
NTVATLYCV	NTVATLYCV
ILLILSCIFA	LLILSCIFA
MAWGGSYIA	MAWGGSYIA
GLLPCLHVA	GLLPCLHVA
RLLLLGLLLL	LLLLGLLLL
YLQLIFGIEV	YLQLFGIEV
YQADLYTYL	YQADLYTYL
TLMNVITLV	TLMNVITLV
VLLDYQGML	VLLDYQGML
WMLGTGVYL	WMLGTGVYL
YLNTNKLFFA	YLNTKLFFA
ALVEMGHHV	ALVEMGHHV
GLLRVISGVL	GLLRVISGV
LLFLLLADA	LLFLLLADA
YLFGGFSTL	YLFGGFSTL
LLAMTFWPA	LLAMTFWPA
VLGSWPVDL	VLGSWPVDL
SISGVLWQV	SISGVLWQV
CINGVCWTV	CINGVCWTV
LLDGTATLRL	LLDGATLRL
ALQNVMISI	ALQNVMISI
RMMETWHPL	RMMETWHPL
KLPRWIFFA	KLPRWIFFA
KLLIVLTCI	KLLIVLTCI
FLMDFIHQV	FLMDFIHQV
DLMCHATFTM	LMCHATFTM
ILQYDLWNV	ILQYDLWNV
VLRDDLLEA	VLRDDLLEA
RSLFNTIAVLY	SLFNTIAVL
SLYDVEFDA	SLYDVEFDA
YLVPNVIGGV	YLVPVIGGV
ITDNGPMPYM	ITDNPMPYM
CINGACWTV	CINGACWTV
RIANGMGATV	RIANMGATV
ILATLNTLI	ILATLNTLI
RLIDRMLTA	RLIDRMLTA
ALLEDPVGT	ALLEDPVGT
NLDDVYSYI	NLDDVYSYI
SMWALVISV	SMWALVISV
SLYDQKEINA	SLYDKEINA
FLYGWLFIL	FLYGWLFIL
FLKSDYFPSV	FLKSYFPSV
FIIDNFGSV	FIIDNFGSV
ALVACVAAL	ALVACVAAL
TVADIWHAM	TVADIWHAM
LLFLVLIML	LLFLVLIML
ITAQVPFSV	ITAQVPFSV
FIIEVSNCV	FIIEVSNCV
YTYSGLFCV	YTYSGLFCV
YLYQPCDLL	YLYQPCDLL
LLPAVQCAV	LLPAVQCAV
VLIAGIILLI	VLIAGIILL
HLSPALADV	HLSPALADV
LLGLWGLAAL	LLGLGLAAL
FMQRIISLSV	FMQRISLSV
NMKEEMARHL	NMKEMARHL
AMYVAIQAV	AMYVAIQAV
SAWESFWRI	SAWESFWRI
RLQPQVGWEV	RLQPVGWEV
YLPEVISTI	YLPEVISTI
FLLFLEITYT	FLLFEITYT
LLILSCIFA	LLILSCIFA
AAITLVVISV	AITLVVISV
RTIMAVLFVV	TIMAVLFVV
HLTENNLYI	HLTENNLYI
SLLYLILFLL	LLYLILFLL
FVFSTSFYLI	FVFSTSFYL
LLGLWVFAAL	LLGLVFAAL
YMREVGAAL	YMREVGAAL
VLSDDLLEA	VLSDDLLEA
MMVILPDKI	MMVILPDKI
AVVYSTCTV	AVVYSTCTV
IISYIILFI	IISYIILFI
ALSALLTKL	ALSALLTKL
FTLDADLGI	FTLDADLGI
FANCNFTLV	FANCNFTLV
RLIDFLKDV	RLIDFLKDV
TFWMGSHEV	TFWMGSHEV
YMIMVKCWM	YMIMVKCWM
ALVAVSLIAI	ALVASLIAI
ILLENLMRA	ILLENLMRA
YQYVRLHEM	YQYVRLHEM
SIFGFQAEV	SIFGFQAEV
FVRELLTEV	FVRELLTEV
LMWYELSKI	LMWYELSKI
ALDISFTGA	ALDISFTGA
KMAGGIGLSI	KMAGIGLSI
VLAEAMSQV	VLAEAMSQV
VLWEGGHDL	VLWEGGHDL
LQLGFSTGV	LQLGFSTGV
YMQQVSEGL	YMQQVSEGL
DLYDYITRI	DLYDYITRI
ALNIALVAV	ALNIALVAV
LLSQYLSRV	LLSQYLSRV
LILNFLDWI	LILNFLDWI
ILNDEQLNL	ILNDEQLNL
NLWNTFTRL	NLWNTFTRL
QLQDTQELL	QLQDTQELL
ALSSDGDTV	ALSSDGDTV
FMYEDALKS	FMYEDALKS
FLSAADDLV	FLSAADDLV
WLMWFIISI	WLMWFIISI
YVVWLMFSL	YVVWLMFSL
ALVLLMLPVV	ALVLLMLPV
YIGEVLVSV	YIGEVLVSV
HLSWEWNLSI	LSWEWNLSI
ALSPVLPPM	ALSPVLPPM
VLWTVFHGA	VLWTVFHGA
MMCYFLTATL	MMCYLTATL
GMQFDKVYL	GMQFDKVYL
YLYFCSSDV	YLYFCSSDV
ILCETCLIV	ILCETCLIV
MINDTHFLL	MINDTHFLL
VLWAHGFEL	VLWAHGFEL
LLPPLLEHL	LLPPLLEHL
TSISGVLWTV	SISGVLWTV
DLTTKNVSI	DLTTKNVSI
ILHCANFNV	ILHCANFNV
VLFTFVLLL	VLFTFVLLL
FVARVFLGL	FVARVFLGL
LLANGNVYA	LLANGNVYA
ELIKELTTL	ELIKELTTL
PLLPIFFCL	PLLPIFFCL
YLAIPDLYGI	YLAIDLYGI
RILQQLLFI	RILQQLLFI
QLFNHTMFIL	QLFNHTMFI
RQISQDVKL	RQISQDVKL
ALLGLTLGV	ALLGLTLGV
KLVYLIVGV	KLVYLIVGV
SLFNTVATL	SLFNTVATL
LMVHSTFLI	LMVHSTFLI
AQASIELPSM	AQASELPSM
LMMMLPATLA	LMMMLPATL
LMIFISSFLL	LMIFSSFLL
LIFILLTAV	LIFILLTAV
YIITCCLFA	YIITCCLFA
SLNRNFTLV	SLNRNFTLV
FIVVATAAV	FIVVATAAV
FLFELIPEP	FLFELIPEP
FIYLLFASM	FIYLLFASM
KSLYNTVAVLY	SLYNTVAVL
DIINSVSIIL	IINSVSIIL
FQFFVFLALA	FQFFVFLAL
FLTSLLILV	FLTSLLILV
ELAGIGILTV	ELAGGILTV
FLYNLLTRV	FLYNLLTRV
TLLYATVEV	TLLYATVEV
FLDLPLPWAA	FLDLPLPWA
TIYSHLLLV	TIYSHLLLV
SVFELSNFA	SVFELSNFA
ELYSPLFLI	ELYSPLFLI
RLFDFFSRV	RLFDFFSRV
SVLTILYYGA	VLTILYYGA
TMFKIVYSL	TMFKIVYSL
KLLWAVEPL	KLLWAVEPL
LAYYNSCMLT	LAYYNSCML
VMCGGSLYV	VMCGGSLYV
LLFNKVTLA	LLFNKVTLA
ETAWPFFYA	ETAWPFFYA
GVYGGLCLA	GVYGGLCLA
SLYNTVATLY	SLYNTVATL
FTNSQIFNI	FTNSQIFNI
MMNITRLEV	MMNITRLEV
FVPYVLALV	FVPYVLALV
LAAEEILTL	LAAEEILTL
IILEFFLIVL	IILEFFLIV
LIDNPDNNL	LIDNPDNNL
AQFLYLYAL	AQFLYLYAL
SIKDSMYVI	SIKDSMYVI
RIMAWTVVNSI	IMAWVVNSI
SLMAFTAAV	SLMAFTAAV
WLGETFHGL	WLGETFHGL
TMLLGVFTV	TMLLGVFTV
LTYSQLMTL	LTYSQLMTL
ILMHATYFL	ILMHATYFL
IMSSFEFQV	IMSSFEFQV
VLEKGIPTL	VLEKGIPTL
VLADDVYPL	VLADDVYPL
YLILFLLFV	YLILFLLFV
LTSLVITYCL	LTSLITYCL
ALSLAAVLVV	ALSLAAVLV
YVSVMNFIPI	YVSVNFIPI
QIGGEAIFLI	QIGGAIFLI
TTFITVLTSV	TTFIVLTSV
WTLETLPRV	WTLETLPRV
CMAFTIPSI	CMAFTIPSI
FLPSDYFPSV	FLPSYFPSV
CLVSGLSSL	CLVSGLSSL
HLCGSHLVEAL	HLCGHLVEA
GLYEWISEQ	GLYEWISEQ
AVAANIVLTV	AVAAIVLTV
LLLSTTEWQV	LLLSTEWQV
FLHEDLEKL	FLHEDLEKL
GLLDWGMQQ	GLLDWGMQQ
KLMDVVYSI	KLMDVVYSI
KIYKIIIWI	KIYKIIIWI
YMFESKSMK	YMFESKSMK
FTASLFLHL	FTASLFLHL
MQDGRFDGI	MQDGRFDGI
LLFFLALSI	LLFFLALSI
RLLGTFTWTL	RLLGFTWTL
TLLCVLPAVV	TLLCVLPAV
YLLSGAGEHL	LLSGAGEHL
HLLCQAFSV	HLLCQAFSV
VVTAIVYVV	VVTAIVYVV
KVCAITPTI	KVCAITPTI
ILSPFLPLL	ILSPFLPLL
DINESMSQMV	DINEMSQMV
VLYNGVNYL	VLYNGVNYL
VLDDGIYRI	VLDDGIYRI
ALMDKSLHV	ALMDKSLHV
IMAAILAYTI	IMAAILAYT
WMTTEDMLAV	MTTEDMLAV
DMWEHAFYL	DMWEHAFYL
QLEHGSCQPV	QLEHSCQPV
LLAGFMAYMI	LLAGFMAYM
LLLLTLLATV	LLLTLLATV
KLSNAKWLA	KLSNAKWLA
ACMDGFEVV	ACMDGFEVV
FLRNQPLTFA	FLRNPLTFA
LQNFCQHLV	LQNFCQHLV
TLDNILGIL	TLDNILGIL
FLAIKLYGV	FLAIKLYGV
ILLPWFVDL	ILLPWFVDL
HIFYQLANV	HIFYQLANV
ILASIIDYV	ILASIIDYV
VLLKTALLIV	VLLKALLIV
LMPLARFWL	LMPLARFWL
GMFANRWII	GMFANRWII
SVGGVFTSV	SVGGVFTSV
RLAEAVVSA	RLAEAVVSA
FVTDYVHEGV	FVTDVHEGV
ALLEACLRV	ALLEACLRV
YLVVVGAVGV	YLVVGAVGV
MIIMLIPTV	MIIMLIPTV
VMMSCSSEA	VMMSCSSEA
ILDGKNCTL	ILDGKNCTL
YALTVVWLL	YALTVVWLL
YMDDVVLGA	YMDDVVLGA
KMGKAGYVT	KMGKAGYVT
KMHFYLPGA	KMHFYLPGA
FLSHDFTLV	FLSHDFTLV
AVHDTLFYCV	AVHDLFYCV
WLKGNISPV	WLKGNISPV
ILMDNKGLGV	ILMDKGLGV
RQIFIHYSV	RQIFIHYSV
TVQEFIFSA	TVQEFIFSA
SLMEHWALGA	SLMEWALGA
NISTILYFT	NISTILYFT
KLRGMGFNAV	KLRGGFNAV
TIAVSVYGA	TIAVSVYGA
FIKQGFNNLV	FIKQFNNLV
VLTDFKTWL	VLTDFKTWL
KASEYLQLV	KASEYLQLV
WMMLLIAQA	WMMLLIAQA
RVMVSPLAV	RVMVSPLAV
YMISTYPGNT	YMISYPGNT
VLTEPLCQV	VLTEPLCQV
SLAALFYSL	SLAALFYSL
YMPYVFTLL	YMPYVFTLL
VLAAGVLVV	VLAAGVLVV
GLLASAPGI	GLLASAPGI
SLTCEVDAL	SLTCEVDAL
NLAPHLLLI	NLAPHLLLI
GLACHQLCA	GLACHQLCA
STQWSLFFFV	TQWSLFFFV
YQLGDYFFV	YQLGDYFFV
GMSLLEYGV	GMSLLEYGV
KLAGGVAVI	KLAGGVAVI
FLQEALNIA	FLQEALNIA
RSLFNTVATLY	SLFNTVATL
LIIDEIGYL	LIIDEIGYL
TLFDDELYSI	TLFDELYSI
CTMERTNDL	CTMERTNDL
TLIASLVMLL	LIASLVMLL
FIFLLFLTL	FIFLLFLTL
FVFRSPFIV	FVFRSPFIV
VLSEWLPVT	VLSEWLPVT
FIDSNEYEV	FIDSNEYEV
AIVGGLAEL	AIVGGLAEL
FVAPYFESV	FVAPYFESV
RMFRWLVLRI	RMFRLVLRI
KMQQNIQEL	KMQQNIQEL
ALSLAAVLV	ALSLAAVLV
GLADQLIHI	GLADQLIHI
LLHVFQEYRL	LLHVQEYRL
CLTEYILWV	CLTEYILWV
ALSEGVYRI	ALSEGVYRI
GLIVGTAFI	GLIVGTAFI
SLSMTCIAV	SLSMTCIAV
SLVKHHMYV	SLVKHHMYV
GLYNFATCGL	GLYNATCGL
HIFMASPENV	IFMASPENV
FANHDFTLV	FANHDFTLV
ILAADLEKL	ILAADLEKL
STISWMMKL	STISWMMKL
YLIIGILTL	YLIIGILTL
TMFGGVSWMV	TMFGVSWMV
FMYFCEQKL	FMYFCEQKL
FVGVIILGV	FVGVIILGV
ALGLVCVQA	ALGLVCVQA
WLLWPVTLA	WLLWPVTLA
WMMAMKYPI	WMMAMKYPI
RLASLLTYA	RLASLLTYA
YVVIAILTVV	VVIAILTVV
KLADYLNVL	KLADYLNVL
NTLMFMVYV	NTLMFMVYV
YLLGRPPNA	YLLGRPPNA
FMSLAGFVRM	FMSLGFVRM
YLLEMLWRL	YLLEMLWRL
ALINLVQYRI	ALINVQYRI
NMNNDSYYF	NMNNDSYYF
FSAVISGSV	FSAVISGSV
SMFERDFHF	SMFERDFHF
CMIRWLGGI	CMIRWLGGI
SLPFQNIHPV	SLPFNIHPV
LLLLDVAPL	LLLLDVAPL
SMSSYDFST	SMSSYDFST
LLAAGVADPV	LLAAVADPV
ALQTDNYTL	ALQTDNYTL
YLFTFTIYT	YLFTFTIYT
RIQQYMFFM	RIQQYMFFM
GLAVAMEV	GLAV-AMEV
MLLILCTSQI	LLILCTSQI
VLENFTIFLV	VLENTIFLV
FLRDNLYHV	FLRDNLYHV
IVALTIMGV	IVALTIMGV
LLGMWGIAAL	LLGMGIAAL
QLMPYGCLL	QLMPYGCLL
LMDSIFVSTM	LMDSIFVST
MMFDAMGAL	MMFDAMGAL
RLLPLLALLA	RLLPLLALL
ATLNTLITL	ATLNTLITL
VELQIGWTV	VELQIGWTV
FIISTLNKIL	FIISTLNKI
RTNEEFDPV	RTNEEFDPV
AMFTTMYNI	AMFTTMYNI
SMNATLVQA	SMNATLVQA
LLLRPFWPA	LLLRPFWPA
KVIQYLAYV	KVIQYLAYV
YILNKPVFI	YILNKPVFI
AMIDRLHQT	AMIDRLHQT
MQVFFGYFA	MQVFFGYFA
FLICHNLRA	FLICHNLRA
SLHNAVAVL	SLHNAVAVL
RLRSSVPGV	RLRSSVPGV
KVLEYVIKV	KVLEYVIKV
RTLLPILLL	RTLLPILLL
TMRDDLPLV	TMRDDLPLV
GLLPSLLLLG	GLLPSLLLL
GLSPTVWLSV	GLSPVWLSV
QAIMESDSFL	AIMESDSFL
WLKEKHEEL	WLKEKHEEL
FVWLHYYSV	FVWLHYYSV
FMVSSIDEL	FMVSSIDEL
LMWITQCFL	LMWITQCFL
LLAQFQHTV	LLAQFQHTV
SLTAISTTL	SLTAISTTL
LLLLVAHYA	LLLLVAHYA
ILDKVLVHL	ILDKVLVHL
FMYEGDTPL	FMYEGDTPL
GILKSILKV	GILKSILKV
VTGCASLYV	VTGCASLYV
KIDKLTFQI	KIDKLTFQI
SLLTEVETYV	LLTEVETYV
MLGNAPSVV	MLGNAPSVV
CMSANEAAI	CMSANEAAI
ALVSGTATA	ALVSGTATA
SQYANCSSI	SQYANCSSI
IILEFFLMVL	IILEFFLMV
FLFMDRDAL	FLFMDRDAL
SLFSLLPGV	SLFSLLPGV
TLFLLFLEI	TLFLLFLEI
ALAKNASEL	ALAKNASEL
ALLFLMSFT	ALLFLMSFT
ILWENNIKL	ILWENNIKL
WLGNIIMYA	WLGNIIMYA
SLFNTIAVL	SLFNTIAVL
NTFYLFTFT	NTFYLFTFT
GLIHACMLV	GLIHACMLV
FGLLPEHYV	FGLLPEHYV
YLPKQPEGVI	YLPKQPEGV
FLFYPSMFTL	FLFYSMFTL
LLAGFMAYM	LLAGFMAYM
TLGIVCPI	TLGI-VCPI
RMSRVTTFTV	RMSRTTFTV
FLCWGPFFL	FLCWGPFFL
LLFKTSVGV	LLFKTSVGV
ALYGSVPVL	ALYGSVPVL
FMPDFSRVI	FMPDFSRVI
TLNEDLLEI	TLNEDLLEI
IILKALYML	IILKALYML
KLSDSKITV	KLSDSKITV
LLPFGQLSI	LLPFGQLSI
YLLGLSAIM	YLLGLSAIM
ALYACVLAA	ALYACVLAA
GMSIVCIVA	GMSIVCIVA
YLLEQLNNL	YLLEQLNNL
MSDIFHALV	MSDIFHALV
VLYDEFVTI	VLYDEFVTI
PLPVSRLVSL	LPVSRLVSL
RSLFNTIATL	SLFNTIATL
GLLDSIKMI	GLLDSIKMI
FLPVDFFPSV	FLPVFFPSV
IIFFIVLILL	IIFFVLILL
FQVDCFLWH	FQVDCFLWH
MLNFSIYSV	MLNFSIYSV
NLVIGFLFL	NLVIGFLFL
FLAAECPFL	FLAAECPFL
SQMTSTFIM	SQMTSTFIM
TLFPGDDDL	TLFPGDDDL
GLAWQAASV	GLAWQAASV
ALMRRIAVV	ALMRRIAVV
YLQLVFGIEV	YLQLFGIEV
AAAATCALV	AAAATCALV
YQMLLALVAL	QMLLALVAL
AVLSEYETMV	VLSEYETMV
GVFEGIAVL	GVFEGIAVL
YTLLGCWSFV	TLLGCWSFV
AVVGFLLGV	AVVGFLLGV
GTYAVNIHV	GTYAVNIHV
RAMACSALI	RAMACSALI
YVASYLLAAL	YVASYLLAA
TMADLVYAL	TMADLVYAL
FINKLNGAMV	FINKNGAMV
FIVPDADPPI	FIVPADPPI
GLNDYLHSV	GLNDYLHSV
LMNNAFEWIV	LMNNAFEWI
MILALTVAI	MILALTVAI
GLICGLRQL	GLICGLRQL
FIIFLFILL	FIIFLFILL
TLFFTTTLFL	TLFFTTLFL
LMGTITLNA	LMGTITLNA
KQWGWFALL	KQWGWFALL
SIDQKKSYV	SIDQKKSYV
IISLFYTFAI	IISLYTFAI
AMQAAELPV	AMQAAELPV
VLSNTSTAV	VLSNTSTAV
FTQKSLFPI	FTQKSLFPI
GMKAFTAAV	GMKAFTAAV
DTVFDYYVL	DTVFDYYVL
ILSDDMLNI	ILSDDMLNI
WLGAAITLV	WLGAAITLV
FSWTITDAV	FSWTITDAV
SCLENFRAYV	CLENFRAYV
FLCAKCLGA	FLCAKCLGA
FLDQVPFSV	FLDQVPFSV
FLHYCNSYA	FLHYCNSYA
IVVALSSLV	IVVALSSLV
IMSMMNITRL	IMSMNITRL
MMPIKSIVTL	MMPISIVTL
TLWCSPIKV	TLWCSPIKV
YIVGYYSAL	YIVGYYSAL
SLIKSTLQV	SLIKSTLQV
GLIPQWVTL	GLIPQWVTL
TLYAVATTFV	TLYAATTFV
KIGDFGLATV	KIGDGLATV
GLLECCARCLV	GLLECARCL
AIIGLCAYA	AIIGLCAYA
FLLRSIIVA	FLLRSIIVA
MIAGVLFTFV	MIAGLFTFV
GLCIRISMV	GLCIRISMV
SLPITVYYA	SLPITVYYA
ALLDLGWTI	ALLDLGWTI
VVPYEPPEV	VVPYEPPEV
FLSTLPSDV	FLSTLPSDV
KILSDENYLL	ILSDENYLL
YTITVFLHL	YTITVFLHL
FTPQFLLQL	FTPQFLLQL
LLVNEFYI	LLVN-EFYI
IILLILSCI	IILLILSCI
FVLELEPEWTV	VLELPEWTV
LLIHFLLSL	LLIHFLLSL
AQMVWIHGV	AQMVWIHGV
ALIARCWYL	ALIARCWYL
LLFILFYFA	LLFILFYFA
RLPVICSFLV	RLPVCSFLV
ILDIAGFEI	ILDIAGFEI
MLEEMQSAV	MLEEMQSAV
DLLNVKMAL	DLLNVKMAL
LLWDYMCIS	LLWDYMCIS
YMIKKLLKI	YMIKKLLKI
SLFLHLVGI	SLFLHLVGI
DINVIGLIV	DINVIGLIV
LLCVLPAVV	LLCVLPAVV
ALVCYIVMPV	ALVCIVMPV
MLLAVLYCL	MLLAVLYCL
MRLLPLLALL	RLLPLLALL
ILASFSAST	ILASFSAST
KLVAMGINAV	KLVAGINAV
FLITGVFDI	FLITGVFDI
ALFSGVSWIM	ALFSGVSWI
RLMNDWAEV	RLMNDWAEV
TSLGLLYTV	TSLGLLYTV
IVGAETFYV	IVGAETFYV
AMWLLLLSI	AMWLLLLSI
SLFNTIATLY	SLFNTIATL
SLFNTVATV	SLFNTVATV
VLPDVFIRC	VLPDVFIRC
ALDVYNGLL	ALDVYNGLL
FLSRLVLYA	FLSRLVLYA
VTYECPLLV	VTYECPLLV
AIMTRCLAV	AIMTRCLAV
WVMDTLNGIM	WVMDTLNGI
KLFSDISAI	KLFSDISAI
AIYGAAFSGV	AIYGAFSGV
YLACELLPA	YLACELLPA
YIPPCQCTV	YIPPCQCTV
IVLYNGVNYL	VLYNGVNYL
KLQDCTMLV	KLQDCTMLV
LLSLFSTLV	LLSLFSTLV
LIVRYLIQV	LIVRYLIQV
LMAVVLASL	LMAVVLASL
YMSFWCKSI	YMSFWCKSI
LVMAFIAFL	LVMAFIAFL
SMMNITRLEV	SMMNTRLEV
FTSDYPFYV	FTSDYPFYV
SSLENFRAYV	SLENFRAYV
YLGIFKNNDV	YLGIKNNDV
SIYECITFL	SIYECITFL
YLDMVLAFL	YLDMVLAFL
YLYASFCTV	YLYASFCTV
FVFAPTHGL	FVFAPTHGL
LLLVAHYAI	LLLVAHYAI
YLVSFGVWI	YLVSFGVWI
QLMCQPILL	QLMCQPILL
KLSSYHVVSV	KLSSHVVSV
LLVAPMPTA	LLVAPMPTA
ALLFLMSFTI	LLFLMSFTI
SLYNAVATL	SLYNAVATL
VLIGGKPDRV	VLIGKPDRV
FLLRWEQEI	FLLRWEQEI
SIVAYTMSL	SIVAYTMSL
YLGEVIVSV	YLGEVIVSV
YFLRRLALV	YFLRRLALV
FLPSDYFPST	FLPSYFPST
ILCGTCLIV	ILCGTCLIV
RLRDLNQAV	RLRDLNQAV
YTALHYYYL	YTALHYYYL
ALPHIIDEV	ALPHIIDEV
SLFNTIATL	SLFNTIATL
ALPVYLMTL	ALPVYLMTL
VLDATNDGLI	VLDATNDGL
KTSTLIFFV	KTSTLIFFV
YLGAFLSVL	YLGAFLSVL
FLYGALLL	FLYG-ALLL
IMLEGETKL	IMLEGETKL
LLLEWLAEV	LLLEWLAEV
IIMEEGNSI	IIMEEGNSI
KLAEAIFKL	KLAEAIFKL
LLLISMYAL	LLLISMYAL
YLCDNFCPA	YLCDNFCPA
SLTQVKELGI	SLTQKELGI
FQTVSFSMV	FQTVSFSMV
GMFNMLSTV	GMFNMLSTV
GLSQFTQTV	GLSQFTQTV
VLADAINGL	VLADAINGL
YQGSYGFRL	YQGSYGFRL
VVMGTLVAL	VVMGTLVAL
VLWSLLWLG	VLWSLLWLG
FAAAFFPAV	FAAAFFPAV
ALWMRLLPL	ALWMRLLPL
GLLGSPVRA	GLLGSPVRA
YTQDELINV	YTQDELINV
KLFPEVIDL	KLFPEVIDL
GMFNMLSTVL	GMFNMLSTV
HLTRVGPYL	HLTRVGPYL
WLMKYPYQL	WLMKYPYQL
FLLLGLWGFA	LLLGLWGFA
KLEKASLIEV	KLEKSLIEV
LMMTTIGIV	LMMTTIGIV
FILGIIITV	FILGIIITV
VLYDEFKCFI	VLYDFKCFI
FLFDRLTNG	FLFDRLTNG
SLFGQRIEV	SLFGQRIEV
KLRVLYDEFV	KLRVYDEFV
YLDGQLARL	YLDGQLARL
SLYNTAATL	SLYNTAATL
YLVAYQATT	YLVAYQATT
VLVGGVLAAL	VLVGVLAAL
LLRRRPYPL	LLRRRPYPL
FAGKTVWFV	FAGKTVWFV
TMHSLTIQM	TMHSLTIQM
FLLAQFTSA	FLLAQFTSA
FLGSCICFI	FLGSCICFI
RLQSLQTYV	RLQSLQTYV
FVNFNSVKNL	FVNFSVKNL
SMELPSFGV	SMELPSFGV
FLDLPLPWA	FLDLPLPWA
MMMNWSPTT	MMMNWSPTT
YLGEVLVSV	YLGEVLVSV
KLLYAAEMV	KLLYAAEMV
FTASLFLHLV	FTASFLHLV
LMWFIISIV	LMWFIISIV
VVTLLCVLPA	VTLLCVLPA
QTIDNIVFL	QTIDNIVFL
VICSFLVFLV	VICSLVFLV
FLLMDALKLSI	FLLMDALKL
ILPILVLAL	ILPILVLAL
FMTSSWWRAPL	FMTSSWWRA
IMMNERDVSV	MMNERDVSV
SILSPFLPLL	ILSPFLPLL
YLSIYGFGV	YLSIYGFGV
KVVSLVILA	KVVSLVILA
RLLDLFGPEV	RLLDFGPEV
MLFVNDLMTM	MLFVDLMTM
KTMAMALSIV	TMAMALSIV
ETDDYMFFV	ETDDYMFFV
SLVSKHWEL	SLVSKHWEL
KTIECSKEL	KTIECSKEL
YIILFILFFA	IILFILFFA
FMIEGLMTSL	FMIELMTSL
ILFFAYVMNI	ILFFYVMNI
RIEDMFLTSV	RIEDFLTSV
YLSGANLNV	YLSGANLNV
LLLHSLTPL	LLLHSLTPL
MTSCVSEQL	MTSCVSEQL
LLACAVIHA	LLACAVIHA
MVDVSMMSM	MVDVSMMSM
ALMTLDDLA	ALMTLDDLA
TLISLNSMYT	TLISNSMYT
WMAETTLGRV	WMAETLGRV
IMQVFFGYFA	IMQVFGYFA
YLMAWKQVL	YLMAWKQVL
LLAVLYCLL	LLAVLYCLL
YLNTLTLAV	YLNTLTLAV
YMLWNSWLS	YMLWNSWLS
ELVRYIELV	ELVRYIELV
FISIYSRPKI	FISISRPKI
KLDDTGKKEL	KLDDGKKEL
ITMGSLFFV	ITMGSLFFV
ILSCIFAFI	ILSCIFAFI
KLVALGINAV	KLVAGINAV
NTFYLFTFTI	NTFYFTFTI
SLRNVLAAV	SLRNVLAAV
QLPLESDAV	QLPLESDAV
ILIRLTLLL	ILIRLTLLL
SMIEAESSV	SMIEAESSV
ELLEMKYAL	ELLEMKYAL
ITMSAFLIV	ITMSAFLIV
SLKDVLVSV	SLKDVLVSV
SISEINEWL	SISEINEWL
RAMASDFNL	RAMASDFNL
LMIERFVSL	LMIERFVSL
RLTEDDFGL	RLTEDDFGL
FTSSFYNYV	FTSSFYNYV
FLTDYIPGA	FLTDYIPGA
MVNHSTYYV	MVNHSTYYV
QLDKCSAFV	QLDKCSAFV
YQVKYVSPV	YQVKYVSPV
GLHTEFQTV	GLHTEFQTV
GLPMNTGWV	GLPMNTGWV
ILAGVSLLPV	ILAGSLLPV
KLANIQCPCL	KLANQCPCL
ILGLPTQTV	ILGLPTQTV
ALSRKVAEL	ALSRKVAEL
FMNRFYITT	FMNRFYITT
ALSPPLLLL	ALSPPLLLL
TLIDFYLCFL	TLIDYLCFL
MQALQLLLEV	QALQLLLEV
YLHIHPFKI	YLHIHPFKI
NLFTFLHEI	NLFTFLHEI
SLMEHWALG	SLMEHWALG
WLWYIKIFI	WLWYIKIFI
IMAIGIVSI	IMAIGIVSI
CFMYSDFHF	CFMYSDFHF
NLWVTVYYGV	NLWVVYYGV
HVAAFSSLI	HVAAFSSLI
LLENDMKFTV	LLENMKFTV
CLPACVYGL	CLPACVYGL
GLPPGTPAV	GLPPGTPAV
FVGKTVWFV	FVGKTVWFV
KLLPVHYYM	KLLPVHYYM
QVIFKCVPK	QVIFKCVPK
MMISAGFSL	MMISAGFSL
FLPADFFPSI	FLPAFFPSI
KLSCAVHLI	KLSCAVHLI
FMQALQLLL	FMQALQLLL
FSTSFYLISI	STSFYLISI
VMNNLSELTA	VMNNSELTA
ALLALTRAI	ALLALTRAI
KLNGAMVEYV	KLNGMVEYV
NSLILLECFV	SLILLECFV
SLGKSPLPSL	SLGKPLPSL
FCSDALTLI	FCSDALTLI
VLYPVIFIT	VLYPVIFIT
LMPSPPMPV	LMPSPPMPV
KLRSSPPIPM	KLRSPPIPM
SLLPAIVEL	SLLPAIVEL
RLDALVVAA	RLDALVVAA
YLPLSVFII	YLPLSVFII
YMMGIEYGL	YMMGIEYGL
YIVGANIET	YIVGANIET
SLYNTVATL	SLYNTVATL
QLWATLLSL	QLWATLLSL
RVYAELAAL	RVYAELAAL
MLMFIFTGI	MLMFIFTGI
KILNPYMPSV	ILNPYMPSV
YLRLYIILA	YLRLYIILA
YVGDTSMMV	YVGDTSMMV
MRLLPLLAL	MRLLPLLAL
YLALLEACL	YLALLEACL
GLNTFTNMEV	GLNTTNMEV
FLFLAWIML	FLFLAWIML
GLDSYVRSL	GLDSYVRSL
GLCTLVAML	GLCTLVAML
YVVAYQATV	YVVAYQATV
GLFVSLPVV	GLFVSLPVV
MAMTGLPQA	MAMTGLPQA
IMPQGEAGL	IMPQGEAGL
SLYAVTTAV	SLYAVTTAV
VLAALAAYCL	VLAAAAYCL
ILWDYFSLV	ILWDYFSLV
SLLLVVEGV	SLLLVVEGV
MLLMLLPTAL	LLMLLPTAL
LIFHFFLFLL	LIFHFLFLL
SLEATFIDV	SLEATFIDV
FLYNRPLSV	FLYNRPLSV
SLLERGQQLGV	SLLERGQQL
NLNQVIQSV	NLNQVIQSV
VLMAVVLASL	VLMAVLASL
TQFGVPFVL	TQFGVPFVL
QLWTALISL	QLWTALISL
FIDTVSVYT	FIDTVSVYT
SMGLITIAV	SMGLITIAV
KMFNSVGGA	KMFNSVGGA
QLMAEKLQL	QLMAEKLQL
LQDSVDFSL	LQDSVDFSL
AIDDFCLFA	AIDDFCLFA
YVLFTVMTYV	VLFTVMTYV
YVLHFACLV	YVLHFACLV
ILPDKIDGL	ILPDKIDGL
MIYDLNAVT	MIYDLNAVT
LLKDLMPFV	LLKDLMPFV
SLYNTVAAL	SLYNTVAAL
HLYSHPIIL	HLYSHPIIL
FQFICNLLL	FQFICNLLL
QLLKILDNL	QLLKILDNL
YLLMHLVSL	YLLMHLVSL
HLTPAQLSM	HLTPAQLSM
GLFAEDSPL	GLFAEDSPL
AAVEQILTSV	AVEQILTSV
LLSCLTTPA	LLSCLTTPA
SLPPPGTRV	SLPPPGTRV
FAEGVVAFL	FAEGVVAFL
VMHINSPFKV	VMHISPFKV
LMSGKDVFYL	LMSGDVFYL
LVLQAGFFL	LVLQAGFFL
FLIVRLNQCM	FLIVRLNQC
VILFIMFMLI	ILFIMFMLI
ILRKIFYSV	ILRKIFYSV
KLANPLPYT	KLANPLPYT
QMWKCLIRL	QMWKCLIRL
RSLYNTVATL	SLYNTVATL
FMEEEIKAEM	FMEEIKAEM
FLQEALNIAL	FLQELNIAL
KSLYNTIATLY	SLYNTIATL
FVFAWFNGV	FVFAWFNGV
ALYYSVENV	ALYYSVENV
VLMMRTTWA	VLMMRTTWA
FLAPELVRA	FLAPELVRA
YLVAYKATV	YLVAYKATV
FLQPTADLL	FLQPTADLL
LLASMVEEA	LLASMVEEA
GLLTVCYVL	GLLTVCYVL
LISGSTFSI	LISGSTFSI
KSLFNTIATLY	SLFNTIATL
VILPACAFV	VILPACAFV
GLLPLLLLLG	GLLPLLLLL
SMVNGVVKL	SMVNGVVKL
SMPDFDLHL	SMPDFDLHL
ALYGALLLA	ALYGALLLA
FTLPVLTFV	FTLPVLTFV
YMVTDKTAYI	YMVTKTAYI
LLPENNVLSPV	LLPEVLSPV
QLVGRVFAGL	LVGRVFAGL
YFVAYQATV	YFVAYQATV
FIFTGITLFL	FIFTITLFL
IMAVGMVSI	IMAVGMVSI
LVIGFLFLA	LVIGFLFLA
FAVQTIVFI	FAVQTIVFI
LMLVAHYAI	LMLVAHYAI
FLEQQNKILL	FLEQNKILL
FLHESDPMVI	FLHESDPMV
RVIGLCIRI	RVIGLCIRI
FLTCTDRSV	FLTCTDRSV
FLHSGTAKS	FLHSGTAKS
LLLWPLYVL	LLLWPLYVL
GLQADAPHL	GLQADAPHL
YMATTILEMV	YMATILEMV
RMPEAAPPV	RMPEAAPPV
FIMIVGGLV	FIMIVGGLV
SLWKDGAPL	SLWKDGAPL
VMYASALVLL	VMYAALVLL
TLACFVLAAV	TLACVLAAV
VLFVVTLIPL	VLFVTLIPL
RLFTKVKPL	RLFTKVKPL
GLVGLVTFL	GLVGLVTFL
LLADGLAKA	LLADGLAKA
AIIDPLIYA	AIIDPLIYA
LLTDTIESA	LLTDTIESA
MMIDDFGTA	MMIDDFGTA
WLLGFIKCI	WLLGFIKCI
RLLQETELV	RLLQETELV
IISLWDQSL	IISLWDQSL
HLEWLLGFI	HLEWLLGFI
SLLMWITQV	SLLMWITQV
MLWMAEIPL	MLWMAEIPL
HLECRTFFL	HLECRTFFL
FLNQANCKI	FLNQANCKI
LLKLWIDKV	LLKLWIDKV
SLKERIDML	SLKERIDML
LLLETKTILV	LLLEKTILV
VLRDDLCEA	VLRDDLCEA
RLLCALTSL	RLLCALTSL
TLWAIINTI	TLWAIINTI
KLAVYYYII	KLAVYYYII
ALGYTTEEI	ALGYTTEEI
LVFGKEVVEV	LVFGEVVEV
LLGTFTWTL	LLGTFTWTL
KVAEIVHFL	KVAEIVHFL
NIAEYIAGL	NIAEYIAGL
GAWCYDYTV	GAWCYDYTV
SLLEIGEGV	SLLEIGEGV
VMAPDKPSL	VMAPDKPSL
QIIGYVIGT	QIIGYVIGT
TSVDLNAPV	TSVDLNAPV
FVDYNFTIV	FVDYNFTIV
FIFFLLLAGR	FIFFLLLAG
RLFTKVKPLL	RLFTVKPLL
YVMTMILFL	YVMTMILFL
LLMDALKLSI	LLMDLKLSI
TVIHLEWLL	TVIHLEWLL
SRWAISHWL	SRWAISHWL
VLFIHPLDA	VLFIHPLDA
YMPDVLEKL	YMPDVLEKL
MLLNVQTLI	MLLNVQTLI
YIWIKNLET	YIWIKNLET
AIAKAAAAV	AIAKAAAAV
LLEIHQYPA	LLEIHQYPA
MIIIVIAII	MIIIVIAII
MTSERTLAV	MTSERTLAV
ILIEGIFFV	ILIEGIFFV
FLDLPLPWL	FLDLPLPWL
FLQQSIFRF	FLQQSIFRF
ALTVVWLLV	ALTVVWLLV
ALGDLFQSI	ALGDLFQSI
YLSRTQRLA	YLSRTQRLA
RSLYNTVAVLY	SLYNTVAVL
RTFHIFYYL	RTFHIFYYL
VVMSWAPPV	VVMSWAPPV
KLKDVLLQV	KLKDVLLQV
ALLGAWPAV	ALLGAWPAV
FHFNPLPNV	FHFNPLPNV
IVDTVSALV	IVDTVSALV
VLMTHFFSV	VLMTHFFSV
FVLVDNVDFA	VLVDNVDFA
VVLGVVFGI	VVLGVVFGI
GLFGKGSLV	GLFGKGSLV
GLFGDIYLA	GLFGDIYLA
ALYNTVATL	ALYNTVATL
TLLRLACEV	TLLRLACEV
KVIKLVKSL	KVIKLVKSL
LITMLSIIL	LITMLSIIL
IVIEAIHTV	IVIEAIHTV
RVYAHVRSV	RVYAHVRSV
YIIKLVFLWL	YIIKVFLWL
LMLLALIAV	LMLLALIAV
KLQKDLEGL	KLQKDLEGL
TLDAANHSI	TLDAANHSI
CLALSDLLV	CLALSDLLV
GLFPFHFTL	GLFPFHFTL
TLLCLIPTV	TLLCLIPTV
ALREEEEGV	ALREEEEGV
ILVCYILYI	ILVCYILYI
FLRGRAYGI	FLRGRAYGI
VQYRILPMI	VQYRILPMI
FMTSSWWRA	FMTSSWWRA
RTDAWSYPV	RTDAWSYPV
FLDNECHTI	FLDNECHTI
SLCLMMMLPA	SLCLMMLPA
KLSYGIATV	KLSYGIATV
KLFPRLPGI	KLFPRLPGI
LLLVRAYWL	LLLVRAYWL
KLVVVGAVGV	KLVVGAVGV
FMRDEVSFSV	FMRDVSFSV
LLNPCLINV	LLNPCLINV
ALLADKFPV	ALLADKFPV
KLSGLGINAV	KLSGGINAV
YLIGGSATL	YLIGGSATL
GLRQQLEDI	GLRQQLEDI
FLTCDANLAV	FLTCANLAV
FLEGALIANI	FLEGLIANI
VVMAYVGIKL	VMAYVGIKL
FVDFVIHGL	FVDFVIHGL
YLVDVETIGV	YLVDETIGV
DMLLNVQTLI	MLLNVQTLI
MMQDREDQSI	MQDREDQSI
FLTLLGIGCV	FLTLGIGCV
IMIGVLVGV	IMIGVLVGV
AVGIGLRLV	AVGIGLRLV
YLHRDIFDI	YLHRDIFDI
MICCDSRIVV	MICCSRIVV
MLNGIMYRL	MLNGIMYRL
ILHNIYRLFT	ILHNYRLFT
ALAPAPAEV	ALAPAPAEV
FQVDCFLWHV	FQVDFLWHV
YVITTQHWL	YVITTQHWL
HLAVIGALL	HLAVIGALL
ILLSCIHTT	ILLSCIHTT
VTWHRYHLL	VTWHRYHLL
VLIAGIILL	VLIAGIILL
YLCFLAFLL	YLCFLAFLL
YISQFSYKEL	YISQSYKEL
FLALIICNA	FLALIICNA
LLLEAGALV	LLLEAGALV
ALVFLILCFT	ALVFILCFT
VMWAGPWSS	VMWAGPWSS
KLQDLTLRC	KLQDLTLRC
LMSIISTFHL	LMSISTFHL
CMWGRLWQL	CMWGRLWQL
MIYGLIACL	MIYGLIACL
FLCPTFTLK	FLCPTFTLK
ALVAWLTHA	ALVAWLTHA
LMQSLYDWI	LMQSLYDWI
LVDNVDFAT	LVDNVDFAT
AIHNVVHAI	AIHNVVHAI
LMTFWNPPV	LMTFWNPPV
FLLNKEMYL	FLLNKEMYL
HLDDVGFLV	HLDDVGFLV
EMPPHIYAI	EMPPHIYAI
KIEIERKKL	KIEIERKKL
GLYNLLIRC	GLYNLLIRC
LLPGFVLTCI	LLPGVLTCI
SLAGFVRML	SLAGFVRML
VLYRYGSFSV	VLYRGSFSV
GLLQFIVFL	GLLQFIVFL
SPGGFVQFV	SPGGFVQFV
FIQNIDFKA	FIQNIDFKA
MLVGHMPFM	MLVGHMPFM
ILWGYGFLQ	ILWGYGFLQ
TLVEVTLGEV	TLVETLGEV
QLLWFHISCL	LLWFHISCL
ILMQVPFSV	ILMQVPFSV
NMLDDFSAGA	MLDDFSAGA
SLLSLEHTL	SLLSLEHTL
YLNTPGLPV	YLNTPGLPV
LIMFEQYFI	LIMFEQYFI
FLRYHCPGL	FLRYHCPGL
NMINKLYGYA	MINKLYGYA
YITDYSNDI	YITDYSNDI
FLIDGPETA	FLIDGPETA
GMPNWCVSI	GMPNWCVSI
KLIGITAIM	KLIGITAIM
TLAQSLIDV	TLAQSLIDV
FSMQGAWAKV	SMQGAWAKV
LLVAAGMEA	LLVAAGMEA
ALMAGYFKI	ALMAGYFKI
GLADQLIHL	GLADQLIHL
LLMTSLQYA	LLMTSLQYA
VLSEYETMV	VLSEYETMV
MVAKYDLLV	MVAKYDLLV
NLLDRLLLI	NLLDRLLLI
YLPRFLFGV	YLPRFLFGV
KVHADDIPV	KVHADDIPV
FIASAPQQL	FIASAPQQL
FIALWIPDL	FIALWIPDL
NTIDQTANV	NTIDQTANV
YLSQIAVLL	YLSQIAVLL
NASYITPYV	NASYITPYV
SLVITYCLV	SLVITYCLV
RLQEALAVV	RLQEALAVV
YIYNHLTPL	YIYNHLTPL
MVMCGGSLYV	VMCGGSLYV
VILNYIPVL	VILNYIPVL
FQPSDYFPSV	FQPSYFPSV
TVVPLMAFL	TVVPLMAFL
ALQEAYYRA	ALQEAYYRA
KLYDSVYLT	KLYDSVYLT
IILKANFSV	IILKANFSV
ILTAILFFM	ILTAILFFM
FLGQADFSL	FLGQADFSL
YQVEGATRV	YQVEGATRV
YIALCKVTV	YIALCKVTV
FIMFMLIFNV	IMFMLIFNV
TMYYKDVTV	TMYYKDVTV
YLCTFMIIT	YLCTFMIIT
SHLVEALYL	SHLVEALYL
ALAVFQPAV	ALAVFQPAV
TLRGLFFSV	TLRGLFFSV
FLYNVYPGA	FLYNVYPGA
KSLFNTVATL	SLFNTVATL
KMHDVIAPA	KMHDVIAPA
KMTFLFPNL	KMTFLFPNL
GLISLILQI	GLISLILQI
FLPNDFFPSV	FLPNFFPSV
ILSSLGLPV	ILSSLGLPV
HLVEALYLV	HLVEALYLV
YQLAVTITA	YQLAVTITA
SMVNGVVRL	SMVNGVVRL
SLVENNFFT	SLVENNFFT
FLKDVMESM	FLKDVMESM
RRSLLAHVR	RRSLLAHVR
AMALSIVSL	AMALSIVSL
GLYYLTTEV	GLYYLTTEV
IILTLIPRL	IILTLIPRL
TLFYCDERDA	TLFYDERDA
FMHIWLQAA	FMHIWLQAA
MMLAQAYYG	MMLAQAYYG
QLMCQPILLL	LMCQPILLL
SMYCSKTFL	SMYCSKTFL
YLWPGPVTV	YLWPGPVTV
TLGIVCPIC	TLGIVCPIC
AVWISLAQV	AVWISLAQV
FIAGLIAIV	FIAGLIAIV
YIFFASFYYI	YIFFSFYYI
TMAMVLSIV	TMAMVLSIV
RMFGMPTAL	RMFGMPTAL
VMTPSPFYTV	MTPSPFYTV
MMLVPLITV	MMLVPLITV
LMTLDDLAI	LMTLDDLAI
SLMASSPTSI	SLMASPTSI
ILSDENYLL	ILSDENYLL
FIDGISLGL	FIDGISLGL
TLYDFDYYII	TLYDFDYYI
SMGNTLTCYV	SMGNLTCYV
HMIDKLFYV	HMIDKLFYV
FILLLCLIFL	ILLLCLIFL
HADDIPVPV	HADDIPVPV
KLITSAFDLL	KLITAFDLL
GLVDLFVFS	GLVDLFVFS
KMDLGVPLL	KMDLGVPLL
FLLGLLVHV	FLLGLLVHV
MLMTGTLAVF	MLMTGTLAV
LLLMRTSWAL	LLMRTSWAL
WLDQVPFSV	WLDQVPFSV
FLRGQAAAL	FLRGQAAAL
ILFQRTFSI	ILFQRTFSI
AMIELCGAFL	AMIECGAFL
LLVLCVTQV	LLVLCVTQV
SLVGIDPFRL	SLVGDPFRL
QIFEVYWYL	QIFEVYWYL
SLSKQDISL	SLSKQDISL
LLDPLYFEV	LLDPLYFEV
RLASIELPSV	RLASELPSV
YLKAYQATV	YLKAYQATV
FTLIDIWFL	FTLIDIWFL
ILAKAIFKL	ILAKAIFKL
MLLVLCVTQV	LLVLCVTQV
FLSSSALAV	FLSSSALAV
LMDALKLSI	LMDALKLSI
SLQLVFGIEL	SLQLFGIEL
GLISGSTFSI	GLISSTFSI
CISQHQHLA	CISQHQHLA
VLSDFKTWL	VLSDFKTWL
YLREYVTRL	YLREYVTRL
FISSFLLPL	FISSFLLPL
LLGSFELTGI	LLGSELTGI
FLRYLLFGI	FLRYLLFGI
TMDPSVRVL	TMDPSVRVL
SLHNLVHSFL	SLHNVHSFL
YVYPDNLPV	YVYPDNLPV
YAMCLNTFVL	YAMCLNTFV
NIIDWQFAI	NIIDWQFAI
FLARFWTRA	FLARFWTRA
SIDHCSSFI	SIDHCSSFI
NILMDSIFV	NILMDSIFV
FLQDVMNIL	FLQDVMNIL
ITLYDFDYYI	TLYDFDYYI
MLLATREYV	MLLATREYV
NMLRIMASL	NMLRIMASL
VLFRLENHA	VLFRLENHA
ILSLFLISLV	ILSLFLISL
YLSGANLNL	YLSGANLNL
VLLGAPVVV	VLLGAPVVV
SLVTSFLLM	SLVTSFLLM
SLYNAVVTL	SLYNAVVTL
IASILSLETV	ASILSLETV
YTMADLVYA	YTMADLVYA
YAMCLNTFV	YAMCLNTFV
ILIEGIFFA	ILIEGIFFA
DTCLLAISAV	TCLLAISAV
KQMEDGHTL	KQMEDGHTL
FLFILLLCL	FLFILLLCL
RLVSGLVGA	RLVSGLVGA
TLKDGDFIL	TLKDGDFIL
FLTTPVPSL	FLTTPVPSL
GLFQPFMFV	GLFQPFMFV
KLLPDTAAV	KLLPDTAAV
TLIPRLFAL	TLIPRLFAL
FMTSSWWGA	FMTSSWWGA
YLVAYQATF	YLVAYQATF
GLLQVHHSCPL	LLQVHSCPL
FMIAATYNFAV	MIAAYNFAV
SLHSLSVET	SLHSLSVET
YLDYDTIYV	YLDYDTIYV
ALPDTVAPV	ALPDTVAPV
IMFTCMDPL	IMFTCMDPL
FLASLVVLA	FLASLVVLA
AISAVYFKA	AISAVYFKA
FVSCDFTIV	FVSCDFTIV
SLDAKQWSV	SLDAKQWSV
WMTTEDMLTV	MTTEDMLTV
ALSIVSLFPL	ALSISLFPL
NLLGRFELIGI	NLLGRFELI
ALFSSCPV	ALFS-SCPV
SLFNTVAVLY	SLFNTVAVL
TVLSFCAFA	TVLSFCAFA
SLTTIGTIA	SLTTIGTIA
VMIAMEGGHA	VMIAEGGHA
GLIDIAPHQI	GLIDAPHQI
FLLTRILTI	FLLTRILTI
YLLADTFTV	YLLADTFTV
SLMAFTASV	SLMAFTASV
VMTEGRHAV	VMTEGRHAV
FLNRFTTTL	FLNRFTTTL
RLDGTTLEV	RLDGTTLEV
NLATSIYTI	NLATSIYTI
SLFGGMSWI	SLFGGMSWI
RILGAVAKV	RILGAVAKV
VTDYVHEGV	VTDYVHEGV
FQLIFFLTL	FQLIFFLTL
SMMSMYGKA	SMMSMYGKA
TMVDKPTEL	TMVDKPTEL
ILIEGVFFA	ILIEGVFFA
LLFLKVPA	LLFL-KVPA
VLAWLYAAV	VLAWLYAAV
NTDHPLSINV	NTDHLSINV
ALFSGVSWVM	ALFSGVSWV
VLTILYYGA	VLTILYYGA
NLIDWFNQT	NLIDWFNQT
WLVHKQWFL	WLVHKQWFL
FLDWIKDIMT	FLDWKDIMT
KQWIVAGAI	KQWIVAGAI
ALFGIKLPAL	ALFGKLPAL
TLMLVALLGA	LMLVALLGA
KLQVELDNV	KLQVELDNV
VLTALLAGL	VLTALLAGL
SIFISFYLI	SIFISFYLI
ALIGTMCGI	ALIGTMCGI
AMLGTHTMEV	AMLGHTMEV
FTMEWFLSGL	FTMEFLSGL
LLWSFQTSA	LLWSFQTSA
SLSSIRFHI	SLSSIRFHI
FLMPVEDVFI	FLMPEDVFI
ILDSVGIEA	ILDSVGIEA
SLLRKFLYCI	SLLRFLYCI
FQWSDDPFI	FQWSDDPFI
ILLMLVTPSM	LLMLVTPSM
KVGNCDETV	KVGNCDETV
TLLCVLPAV	TLLCVLPAV
KVLNPYMPSV	VLNPYMPSV
FLKIKVTAA	FLKIKVTAA
LTAAVLMLV	LTAAVLMLV
NTIAVITETI	TIAVITETI
MLYFAGGLSV	MLYFGGLSV
GMLECGFPT	GMLECGFPT
VVLSWAPPV	VVLSWAPPV
NLPEDIKRV	NLPEDIKRV
FLVPFVVFL	FLVPFVVFL
ILTVILGVL	ILTVILGVL
FLTQDLPLL	FLTQDLPLL
TLVDICFWST	TLVDCFWST
YLDSGIHSGA	YLDSIHSGA
WLETELVFV	WLETELVFV
AMMWRIAQL	AMMWRIAQL
IVPEFAKQYV	IVPEAKQYV
ELMYIFAAL	ELMYIFAAL
FQYYGIDWV	FQYYGIDWV
GLDPTGVAV	GLDPTGVAV
LLIAITAFT	LLIAITAFT
ALHTALATV	ALHTALATV
ILNGGLGNA	ILNGGLGNA
GLLDRLYDL	GLLDRLYDL
KLVVLGINAV	KLVVGINAV
ALDHYDCLI	ALDHYDCLI
YLPAIVREA	YLPAIVREA
AMITDLEERL	AMITLEERL
LLLLGLWGL	LLLLGLWGL
IMDQVPFSV	IMDQVPFSV
WLLGAAMVGA	LLGAAMVGA
TLMAAILAYT	LMAAILAYT
YLDQVPFSV	YLDQVPFSV
ILQMREIIT	ILQMREIIT
CLFPQTLAA	CLFPQTLAA
CMFGVVSPA	CMFGVVSPA
ILFLWSFLV	ILFLWSFLV
LIWKVNPEI	LIWKVNPEI
FLPKAAYAL	FLPKAAYAL
FVVALIPLV	FVVALIPLV
MLFDQGTLV	MLFDQGTLV
ILFSYDELV	ILFSYDELV
KQFCLSILL	KQFCLSILL
RLLPLWAAL	RLLPLWAAL
TVLRFVPPL	TVLRFVPPL
FTSAVLLLV	FTSAVLLLV
FLNGSCGSV	FLNGSCGSV
MTKVDVELFI	MTKVVELFI
LITNYLPSV	LITNYLPSV
GLNGDSFRV	GLNGDSFRV
KLGFDEIKGL	KLGFEIKGL
ILSLETVKM	ILSLETVKM
SLADTNSLAV	SLADNSLAV
ALAGFFPVL	ALAGFFPVL
YMFFVIKNL	YMFFVIKNL
MLRDRWSLV	MLRDRWSLV
TVLEKNVTV	TVLEKNVTV
LLRVHTEHV	LLRVHTEHV
TLLVAVSFV	TLLVAVSFV
FVFILTAIL	FVFILTAIL
FVFLVLAGR	FVFLVLAGR
FGGGPWWEV	FGGGPWWEV
LLDAHIPQL	LLDAHIPQL
MLMTGTLAV	MLMTGTLAV
YLLFGIKCI	YLLFGIKCI
GTSAAAYFV	GTSAAAYFV
TIMGVIFLI	TIMGVIFLI
FLGRYMSAL	FLGRYMSAL
FLLVTLAIL	FLLVTLAIL
IVAQGIAAL	IVAQGIAAL
RSLYNTIATLY	SLYNTIATL
ALVELNSGV	ALVELNSGV
KQLAAVARV	KQLAAVARV
LMTLATWVVGV	TLATWVVGV
ALVAFLRFL	ALVAFLRFL
LMIEYNLLT	LMIEYNLLT
YLARAAGLV	YLARAAGLV
LMDSIFVST	LMDSIFVST
KMYEYVFKG	KMYEYVFKG
FQWPALHEE	FQWPALHEE
ALFGYPVYV	ALFGYPVYV
LLQEYNWEL	LLQEYNWEL
SLYNTITVL	SLYNTITVL
YQDSDVSQEV	YQDSVSQEV
IMMGVLVGV	IMMGVLVGV
YTMCSGKFSI	TMCSGKFSI
SLSHDFTLV	SLSHDFTLV
VVPCEPPEV	VVPCEPPEV
IICEDAMYYA	IICEAMYYA
FSYNVAYAI	FSYNVAYAI
HQFTSNPEV	HQFTSNPEV
KMVELVHFLL	KMVELVHFL
FLFQLNDTI	FLFQLNDTI
KMFCQLAKV	KMFCQLAKV
RLLTKPWDV	RLLTKPWDV
ALIYFLQCI	ALIYFLQCI
FMLPKQDIV	FMLPKQDIV
VVCNDLYKV	VVCNDLYKV
GIYNCCESNI	GIYNCESNI
WLVHRQWFL	WLVHRQWFL
VLLGVVFGV	VLLGVVFGV
KLYCSYEVA	KLYCSYEVA
KSLYNTVATLY	SLYNTVATL
GLYYQGSCYI	GLYYGSCYI
YLLCCNYKL	YLLCCNYKL
ILAGPMPVTV	ILAGMPVTV
LMMILPAAL	LMMILPAAL
IIPFLLVLV	IIPFLLVLV
MQFVDRFVV	MQFVDRFVV
LLGLWGFAAA	LLGLGFAAA
YLKIGTLLV	YLKIGTLLV
SLTECPTFL	SLTECPTFL
ALSGVFCGV	ALSGVFCGV
LMVDSFDPV	LMVDSFDPV
QSAGFAAGL	QSAGFAAGL
ILIGFLVLWI	ILIGLVLWI
FLLRGPFEA	FLLRGPFEA
LAMSTTISV	LAMSTTISV
KIADDRIVV	KIADDRIVV
CILESLFRA	CILESLFRA
ITVGMLIYSM	ITVGLIYSM
MLDTWNEDL	MLDTWNEDL
LQDIEITCV	LQDIEITCV
FLETDAGRV	FLETDAGRV
FILDALAQA	FILDALAQA
GLFPVSIPI	GLFPVSIPI
FLSLGLVSL	FLSLGLVSL
CMVNHSTYYV	MVNHSTYYV
LMWDNVGLV	LMWDNVGLV
ILFPDDVQEL	ILFPDVQEL
KECVDGTLL	KECVDGTLL
FLAIPPTAGI	FLAIPTAGI
MQIAILVTTV	QIAILVTTV
GLYMGNLSQL	GLYMNLSQL
DLKPDNILL	DLKPDNILL
LLLAVAVYA	LLLAVAVYA
NLYDHALMSI	NLYDALMSI
TLLLLTLLAT	TLLLLTLLA
LLSCISVPV	LLSCISVPV
YFDDVTAFL	YFDDVTAFL
FTILEYLYI	FTILEYLYI
LLANNPPPV	LLANNPPPV
DLGPAFTEL	DLGPAFTEL
RLWHYPCTI	RLWHYPCTI
ILQDMRNTI	ILQDMRNTI
GLDLENLYA	GLDLENLYA
MMLRDRWSL	MMLRDRWSL
FLYGGLLLA	FLYGGLLLA
KLSSLGLNAV	KLSSGLNAV
SQMGLSCAL	SQMGLSCAL
SLSHNFTLV	SLSHNFTLV
IMAHCILDL	IMAHCILDL
DLMRRGDLPV	LMRRGDLPV
NLAQDLATV	NLAQDLATV
LLMPILTLT	LLMPILTLT
NVISKIYTL	NVISKIYTL
FLAGVPSAV	FLAGVPSAV
SLAADLEKL	SLAADLEKL
FLAVLSPTI	FLAVLSPTI
TLLVVMGTLV	LLVVMGTLV
FVILYLLAV	FVILYLLAV
MLGTHTMEV	MLGTHTMEV
RLKSSQTIEL	RLKSQTIEL
LLQYWSQEL	LLQYWSQEL
FLGRIWPS	FLGR-IWPS
LLFNSLYPA	LLFNSLYPA
TLVALVGLFV	TLVAVGLFV
IVRTNRNEL	IVRTNRNEL
FIADIGIGV	FIADIGIGV
GLVRLNAFL	GLVRLNAFL
KLFTIAMWL	KLFTIAMWL
LLFGYPVAV	LLFGYPVAV
ILISLINSL	ILISLINSL
YMLKDSAPT	YMLKDSAPT
QLNMEKREV	QLNMEKREV
GVCYYLLMHL	GVCYLLMHL
ILFQVPFSV	ILFQVPFSV
KILSVFFLA	KILSVFFLA
LLALLSCISV	LLALSCISV
LIGNESFAL	LIGNESFAL
ILYMVVDGSV	ILYMVDGSV
NITRLEVIGL	ITRLEVIGL
ALATFTVNI	ALATFTVNI
LMLKATLLCV	LMLKTLLCV
YKDANISMY	YKDANISMY
HLCRYVALL	HLCRYVALL
FTLNHVLAL	FTLNHVLAL
KLRPNSFWFV	KLRPSFWFV
YTLNDAPYI	YTLNDAPYI
FLYVVCSLAV	FLYVCSLAV
RLWHYPCTV	RLWHYPCTV
FLGTSISGV	FLGTSISGV
YLVWQPMSAI	YLVWQPMSA
SLCSCICTV	SLCSCICTV
FSMELPSFGV	FSMEPSFGV
YLIPSVTSL	YLIPSVTSL
IVLFILKIFV	VLFILKIFV
ILNAMITKI	ILNAMITKI
LLMVAVIMAI	LLMVVIMAI
KLIIHNPEL	KLIIHNPEL
ALAGNHWHV	ALAGNHWHV
FLLALLSCL	FLLALLSCL
FTLVAPVSI	FTLVAPVSI
VLGAAIWWV	VLGAAIWWV
YLPEVISTIA	YLPEVISTI
MMMGMFNMLS	MMMGMFNML
ALLAGLVSLL	ALLAGLVSL
ELISSAFKV	ELISSAFKV
FLAIPPTAGV	FLAIPTAGV
DLERKVESL	DLERKVESL
FISSFLLPLT	FISSFLLPL
PLWESATEV	PLWESATEV
RLLPLLALL	RLLPLLALL
MMMGMFNMLST	MMMGMFNML
KLGGYVSFV	KLGGYVSFV
VLLGVKLFGV	VLLGKLFGV
TLQSFRQDV	TLQSFRQDV
ALAKAAAAV	ALAKAAAAV
YMPSVVETL	YMPSVVETL
TMEAMRIMGI	TMEARIMGI
ITDWLNFTL	ITDWLNFTL
NLLLLFVTI	NLLLLFVTI
VMPEKRNVV	VMPEKRNVV
KMVELVHFL	KMVELVHFL
SQLAHLVYV	SQLAHLVYV
KIAPGIADI	KIAPGIADI
SMEAEMIQL	SMEAEMIQL
FLGEDGCWYG	FLGEGCWYG
FLIAYQPLL	FLIAYQPLL
TILDDNLYKV	ILDDNLYKV
KLGFEEIKGL	KLGFEIKGL
GIALAVPCV	GIALAVPCV
KSLYNTIAVL	SLYNTIAVL
GMLPVCPLI	GMLPVCPLI
VMACLVPAA	VMACLVPAA
LLSMITMSA	LLSMITMSA
HLYASLSRV	HLYASLSRV
VLDGFIPGT	VLDGFIPGT
ALAAIENYV	ALAAIENYV
QLVDFLCGL	QLVDFLCGL
ALWGAFPVL	ALWGAFPVL
FMTATPPGA	FMTATPPGA
GALDVSASV	GALDVSASV
LLGLWGFAAL	LLGLGFAAL
KLLPQLPGV	KLLPQLPGV
RLLSPTTIV	RLLSPTTIV
GLLLLGLWGT	LLLLGLWGT
MTMLTRWKI	MTMLTRWKI
TVLEYLVSFGV	VLEYVSFGV
FIDSYLQKL	FIDSYLQKL
QLFSFFEEV	QLFSFFEEV
FLFAFLSAA	FLFAFLSAA
LLVISGVFPV	LLVIGVFPV
MVLMTHFFSV	VLMTHFFSV
SFYGYGFNV	SFYGYGFNV
VMFGLAYFSM	VMFGAYFSM
FVADYLARF	FVADYLARF
SLYNLVKSSV	SLYNVKSSV
LLLDDFVEI	LLLDDFVEI
LLGRFELIGI	LLGRELIGI
ALVALVITI	ALVALVITI
FTEGKINPLL	FTEGKINPL
VLLDYGLHGL	LLDYGLHGL
NLFEKFFPS	NLFEKFFPS
SLLFKTSVGV	LLFKTSVGV
ILDGENCTL	ILDGENCTL
KVLHELFGMDI	KVLHELFGM
GLLATPLFL	GLLATPLFL
ALVSDCASTI	ALVSDCAST
RLMIGTAAA	RLMIGTAAA
QLFEDNYALA	QLFEDNYAL
ILHRLAPWI	ILHRLAPWI
NLPSSENYM	NLPSSENYM
LLTFWNPPT	LLTFWNPPT
RLTSNEIFI	RLTSNEIFI
SVFSRPLPL	SVFSRPLPL
VLLEDGGVEV	VLLEGGVEV
VLSDDLLEV	VLSDDLLEV
CLWWTCYMLV	CLWWCYMLV
VLYGPDTPI	VLYGPDTPI
MLTNAISSRV	MLTNISSRV
RSLFNTVATL	SLFNTVATL
ITNGYLISI	ITNGYLISI
LMIFISSFL	LMIFISSFL
LLMLVTPSM	LLMLVTPSM
LMAAILAYTI	LMAAILAYT
KLHLISLLSL	KLHLSLLSL
WMMAMRYPITA	MAMRYPITA
HFIGYIYEV	HFIGYIYEV
LLSVGVGIYL	LLSVVGIYL
YIIILAVLFI	IIILAVLFI
KTIIDPDFV	KTIIDPDFV
ITAALAWSL	ITAALAWSL
SILEYAKSI	SILEYAKSI
ALLDRDCRV	ALLDRDCRV
FLPGQYMNI	FLPGQYMNI
LLYNGAYHL	LLYNGAYHL
SVLLWMASV	SVLLWMASV
KMIKNLTQL	KMIKNLTQL
VLQAGFFLL	VLQAGFFLL
IILVAVPHV	IILVAVPHV
ALLAGLVSL	ALLAGLVSL
IMIVGGLVGL	MIVGGLVGL
YLFQWNDNV	YLFQWNDNV
MVIFRLMRT	MVIFRLMRT
GLYPAQIKA	GLYPAQIKA
AMPAYNWMTV	AMPANWMTV
AVGELLAPV	AVGELLAPV
SVIDHIHYM	SVIDHIHYM
GLAMGIMML	GLAMGIMML
ILMTHFFSIL	ILMTHFFSI
CLAEYCTSL	CLAEYCTSL
FLKDVEPLL	FLKDVEPLL
FLQQRKPPL	FLQQRKPPL
YVIPDELIDV	VIPDELIDV
FLYGALYLA	FLYGALYLA
FLWSVFWLI	FLWSVFWLI
FLDLPLPWTA	FLDLLPWTA
GLPRYVARL	GLPRYVARL
GLAWIPYFG	GLAWIPYFG
KLFGFGAQF	KLFGFGAQF
ATICLKNEGV	ATICKNEGV
RLIQNSLTI	RLIQNSLTI
FLLPSLATV	FLLPSLATV
AIIRILQQL	AIIRILQQL
RILAYGPCL	RILAYGPCL
YLDFLLLLLI	YLDFLLLLL
TLWVDPYEV	TLWVDPYEV
LLGCAANWIL	LLGCANWIL
LLWKGEGAV	LLWKGEGAV
RLATHLRAV	RLATHLRAV
SLVYGIRCV	SLVYGIRCV
TLLCGAATA	TLLCGAATA
YVFCTVNAL	YVFCTVNAL
GLDDSALDA	GLDDSALDA
MLVCGDDLVV	MLVCGDDLV
FLAHLQWFA	FLAHLQWFA
MALLRLPLV	MALLRLPLV
RIVVALSSLV	IVVALSSLV
VLSPTIGHV	VLSPTIGHV
NLSWLSLDV	NLSWLSLDV
FVPSDYFPSV	FVPSYFPSV
WLIGFDFDV	WLIGFDFDV
SLPLPNFSSL	SLPLNFSSL
ALARGAGTVPL	ALARGAGTV
LVITINYFL	LVITINYFL
FLIYFRSPL	FLIYFRSPL
FLLFLVLIM	FLLFLVLIM
SLFDCIVPV	SLFDCIVPV
AMLAAIRRV	AMLAAIRRV
LLLGLMILL	LLLGLMILL
LMFWSPSHSCA	LMFWSPSHS
EMMAKEEELV	MMAKEEELV
FVKENERVNV	FVKEERVNV
FMAAKAAHL	FMAAKAAHL
YLYALIYFL	YLYALIYFL
RLIQNSITI	RLIQNSITI
SLSTYTVPI	SLSTYTVPI
LVLFACSAV	LVLFACSAV
KLMIYGLPWM	LMIYGLPWM
FNMLSTVLGV	NMLSTVLGV
ILMILIEGI	ILMILIEGI
RALLNMIGM	RALLNMIGM
KTPVIVVPV	KTPVIVVPV
NTSWNDTVT	NTSWNDTVT
YAYGWIPET	YAYGWIPET
WLVIGVAFL	WLVIGVAFL
ITLLCLIPTV	TLLCLIPTV
MQACPVDAI	MQACPVDAI
SLFEGIDFYT	SLFEIDFYT
MIIGEPIIV	MIIGEPIIV
GLKSKTHAV	GLKSKTHAV
KLSGLGFNAV	KLSGGFNAV
HMIAGVFFT	HMIAGVFFT
RLITANPIV	RLITANPIV
FLTSVINRV	FLTSVINRV
YLTSFVVPI	YLTSFVVPI
FLVGQLFTF	FLVGQLFTF
GLIIISIFL	GLIIISIFL
YILWENNIKL	ILWENNIKL
GLYLCVVYV	GLYLCVVYV
QLWTTLLSL	QLWTTLLSL
GLFFSVYAL	GLFFSVYAL
WLPTGTLLV	WLPTGTLLV
QLFHLCLII	QLFHLCLII
SVLLFLAFVV	SVLLFLAFV
FVNHDFTVV	FVNHDFTVV
TLFIGSHVV	TLFIGSHVV
RLQHLVAEI	RLQHLVAEI
YVLLHLLVV	YVLLHLLVV
LNCLSLLLSV	NCLSLLLSV
GLMNNAFEWI	GLMNAFEWI
HMSEFMECNL	HMSEMECNL
ELAAHQKKI	ELAAHQKKI
YLSSVLLAL	YLSSVLLAL
VLVDNVDFAT	VLVDNVDFA
LLGLCGFSAL	LLGLCGFSA
FLFLMSGRGI	FLFLSGRGI
FTTTLFLHLV	FTTTFLHLV
WQTDTTIPL	WQTDTTIPL
MLATDLSLRV	MLATLSLRV
ALMLRLLRI	ALMLRLLRI
WLKDSAIMV	WLKDSAIMV
KIEDLINQLV	KIEDINQLV
SLIAIIKGI	SLIAIIKGI
HLMSDNPKA	HLMSDNPKA
IIWGELFGV	IIWGELFGV
LIQDWIPPL	LIQDWIPPL
LLYDLSTTA	LLYDLSTTA
ALWYFFPVL	ALWYFFPVL
KLQERLAKL	KLQERLAKL
FLWLLWPVT	FLWLLWPVT
FVFRSPFIVI	FVFRSPFIV
LMAEDLANV	LMAEDLANV
ELWWVFYAA	ELWWVFYAA
FLYDISISL	FLYDISISL
KLNKMTVEL	KLNKMTVEL
SLYNLVAVL	SLYNLVAVL
YLEGHGFRF	YLEGHGFRF
NLFEKFFPSS	NLFEKFFPS
AMVPLVMVI	AMVPLVMVI
FITTMAPRV	FITTMAPRV
SLVSKHWELT	SLVSKHWEL
GLVDVCFWST	GLVDCFWST
SLGQYIYET	SLGQYIYET
QMVSSVTFI	QMVSSVTFI
GLARLDALV	GLARLDALV
KMSGKTPAV	KMSGKTPAV
RLLAPITAYA	LLAPITAYA
HLAGFIHAC	HLAGFIHAC
KLMNIQQKL	KLMNIQQKL
VLGDDLLEV	VLGDDLLEV
FISGIQYLA	FISGIQYLA
ILRGTSFVYV	ILRGSFVYV
AIMDKNIML	AIMDKNIML
FMYIESIKV	FMYIESIKV
TLDTAIFTDA	TLDTIFTDA
GLYGNGILV	GLYGNGILV
KQWSWFSLL	KQWSWFSLL
KIWEELSML	KIWEELSML
LLLETSWEAI	LLLETSWEA
FICWHSSEI	FICWHSSEI
GLRDCTMLV	GLRDCTMLV
TLLDFAHGL	TLLDFAHGL
HCIDKTPGL	HCIDKTPGL
RIFYNILEI	RIFYNILEI
GMVIACLLV	GMVIACLLV
YLLALRYLA	YLLALRYLA
CLLTDTIESA	LLTDTIESA
RMAWGGSYI	RMAWGGSYI
ELACLLMYL	ELACLLMYL
YMAKLHAYL	YMAKLHAYL
FLMRNAIQY	FLMRNAIQY
TLMAIDLGEL	TLMADLGEL
TLLCVLAALV	TLLCVLAAL
ALLSDWLPA	ALLSDWLPA
RLQFGPPPV	RLQFGPPPV
WMLLTFLTSL	MLLTFLTSL
LLAFDTQPV	LLAFDTQPV
ILFVVIVGL	ILFVVIVGL
LMGLGKGWPL	LMGLKGWPL
ILISLTNEI	ILISLTNEI
KLGALTGTYI	KLGATGTYI
YLGTALMGA	YLGTALMGA
VLVGGVLAA	VLVGGVLAA
KVYGRYSAV	KVYGRYSAV
HLVEALYLVCG	HLVEALYLV
FGLAKLLGA	FGLAKLLGA
AADLTQIFEV	AADLQIFEV
SLASLLPHV	SLASLLPHV
FLGKIWPS	FLGK-IWPS
AIQIQMFEA	AIQIQMFEA
FTGITLFLL	FTGITLFLL
KMNIQFTAV	KMNIQFTAV
ILRNYLRLYI	ILRNLRLYI
KILAIIFLVL	KILAIIFLV
SLADEAEVYL	SLADAEVYL
SLYHVYEVNL	SLYHYEVNL
PLLFILFYFA	LLFILFYFA
SLLDSLLVM	SLLDSLLVM
KTITTCYLM	KTITTCYLM
FLPWHRLFL	FLPWHRLFL
LLLPIAPEL	LLLPIAPEL
LLHGFSFYL	LLHGFSFYL
LLPFVQWFV	LLPFVQWFV
FTASVSTVV	FTASVSTVV
GLMTAVYLV	GLMTAVYLV
NMVPFFPPV	NMVPFFPPV
TILLGIFFL	TILLGIFFL
ALWGFFPVL	ALWGFFPVL
FLMVLLIPEP	FLMVLIPEP
LLVEVLREI	LLVEVLREI
ALSMGINTV	ALSMGINTV
LMIGTAAAVV	LMIGTAAAV
RQVSVKLLI	RQVSVKLLI
MQRIISLSV	MQRIISLSV
ATAKAAAAV	ATAKAAAAV
SLMNVDAAV	SLMNVDAAV
ALWDVPSPA	ALWDVPSPA
YLLNYAGRI	YLLNYAGRI
LLLFHETGV	LLLFHETGV
CLSDEINHV	CLSDEINHV
KLGNLLLLI	KLGNLLLLI
ATYDKGILTV	ATYDGILTV
FLDDASNSA	FLDDASNSA
FLEPGPVTA	FLEPGPVTA
GLGRHLWRL	GLGRHLWRL
VAANIVLTV	VAANIVLTV
YLKEACNHA	YLKEACNHA
IITILQDIV	IITILQDIV
WLDSVIQYL	WLDSVIQYL
FLYGALLAA	FLYGALLAA
YLSTERDHV	YLSTERDHV
ALTNAQFFV	ALTNAQFFV
LLLDYMTST	LLLDYMTST
VMAAVCLQI	VMAAVCLQI
KLMGTITLNA	KLMGITLNA
FLLPILSQIYT	FLLPILSQI
SLLADVQQL	SLLADVQQL
VLPGVVVPIV	VLPGVVVPI
VQYRGLYQI	VQYRGLYQI
FQNWGIESI	FQNWGIESI
ALIAVLTGGV	ALIALTGGV
FLRFGDFKL	FLRFGDFKL
RLARAIIEL	RLARAIIEL
SLFGAAVSL	SLFGAAVSL
ILMYPTTLL	ILMYPTTLL
KQLEWKWGI	KQLEWKWGI
YTYKWETFL	YTYKWETFL
SMVKLPIFL	SMVKLPIFL
KIWEELSVL	KIWEELSVL
QIFNIISYI	QIFNIISYI
NLYKVYNGI	NLYKVYNGI
IIDQVPFSV	IIDQVPFSV
ELFGEAFEV	ELFGEAFEV
ALMDKVLKV	ALMDKVLKV
MLLAFMTLV	MLLAFMTLV
ALKMTMASV	ALKMTMASV
AMLNGLIYV	AMLNGLIYV
NCLSLLLSV	NCLSLLLSV
AMNREVSSL	AMNREVSSL
RSLFNTIAVL	SLFNTIAVL
KVEKYLPEV	KVEKYLPEV
YIYTRSFQM	YIYTRSFQM
LMMTTIGVVL	LMMTTIGVV
IMGAVLIWV	IMGAVLIWV
GLYLSQIAV	GLYLSQIAV
MLGEETIKV	MLGEETIKV
GLLGSLVGA	GLLGSLVGA
SMDTLLFFL	SMDTLLFFL
ILMHCQTTL	ILMHCQTTL
TLMLLALIAV	LMLLALIAV
GLAGGAATA	GLAGGAATA
LLDTGPFSA	LLDTGPFSA
AMIHKTYIDV	AMIHTYIDV
VLLPVLFGV	VLLPVLFGV
LVLQAGFFLL	VLQAGFFLL
KLAEIFQPF	KLAEIFQPF
FLGDDPSPA	FLGDDPSPA
TLIGDCATV	TLIGDCATV
MLCLLLLSV	MLCLLLLSV
QLFEAHPNV	QLFEAHPNV
LLFGYAVYV	LLFGYAVYV
YTDQVPFSV	YTDQVPFSV
LLWFHISCL	LLWFHISCL
RLGAVILFV	RLGAVILFV
LLTEVETPI	LLTEVETPI
YLYVDKNFI	YLYVDKNFI
RTLDKVLEV	RTLDKVLEV
FLIFHFFLFL	FLIFFFLFL
GLPESTPSL	GLPESTPSL
FKNSSNLFT	FKNSSNLFT
GVNACQVGV	GVNACQVGV
FLEDLSYPA	FLEDLSYPA
IIPFIAYFV	IIPFIAYFV
NLNIVRDMLV	NLNIRDMLV
LLNNSLGSV	LLNNSLGSV
MIYDLNAVTT	MIYDLNAVT
SMYVIPDEL	SMYVIPDEL
GLYRQWALA	GLYRQWALA
MIFVSSIFI	MIFVSSIFI
YHLGGIEGL	YHLGGIEGL
VLLPFYETL	VLLPFYETL
NLADQLIHL	NLADQLIHL
FVLAAVYRI	FVLAAVYRI
SISGVLWTV	SISGVLWTV
MMHASTSPF	MMHASTSPF
TLVPQEHYV	TLVPQEHYV
NLYVSLLLL	NLYVSLLLL
AIAWGAWGEV	AIAWAWGEV
IMFKDDNIIM	IMFKDDNII
RLLGFADTV	RLLGFADTV
FLAPLPIHTA	FLAPPIHTA
GLMWLSYFV	GLMWLSYFV
AIMEKNIML	AIMEKNIML
IILNGSLLTL	ILNGSLLTL
AQRWANQIR	AQRWANQIR
RLSNRICFWA	RLSNICFWA
KLSMGLIAI	KLSMGLIAI
NVFKYLTSV	NVFKYLTSV
FLIYLDVSV	FLIYLDVSV
YQDPQNYEL	YQDPQNYEL
LNIMNKLNI	LNIMNKLNI
YLALMATFKM	YLALATFKM
SVFRENLFL	SVFRENLFL
RMQKEITAL	RMQKEITAL
ETDLNQWMV	ETDLNQWMV
ILMDTICGT	ILMDTICGT
FLGGTPVCL	FLGGTPVCL
RVACRDVEV	RVACRDVEV
ATVGIMIGV	ATVGIMIGV
NLAADLTQI	NLAADLTQI
FWMSPVFNL	FWMSPVFNL
CLMMILPAA	CLMMILPAA
LLIQGLKTV	LLIQGLKTV
GLLCISIMI	GLLCISIMI
GLIACLIFV	GLIACLIFV
SLLPLSLLFL	SLLPSLLFL
KIDSTSFSV	KIDSTSFSV
SLLTFMIAA	SLLTFMIAA
KILSDENYL	KILSDENYL
ILVVSLLLV	ILVVSLLLV
GLYIPGTSV	GLYIPGTSV
GLYKQPGVPV	GLYKPGVPV
KQLGQVMLLV	QLGQVMLLV
VLAKDGTEV	VLAKDGTEV
LIALSVLAV	LIALSVLAV
FMLCLLLLSV	FMLCLLLSV
IMAFILGII	IMAFILGII
ITYQVPFSV	ITYQVPFSV
KTMAMVLSIV	TMAMVLSIV
GLVDEQQEV	GLVDEQQEV
NLFDWMHFL	NLFDWMHFL
KLQPSDTLL	KLQPSDTLL
FLSNGHVTI	FLSNGHVTI
VLGDDLLEA	VLGDDLLEA
CALVSDCAST	ALVSDCAST
ALLAGFMAYM	LLAGFMAYM
GLFPQLSAI	GLFPQLSAI
VLIAFGRFPI	VLIAGRFPI
FLIFFDLFLV	FLIFDLFLV
VLHELFGMDI	VLHEFGMDI
VLQAGITRV	VLQAGITRV
KINIFMAFL	KINIFMAFL
SLMAFTASI	SLMAFTASI
CLSDLLGFL	CLSDLLGFL
FVGLSPTVWL	FVGLPTVWL
LTFGWCFKLV	LTFGWCFKL
ALGLSAFGV	ALGLSAFGV
VLSDFKSWL	VLSDFKSWL
AILHNIYRL	AILHNIYRL
RQLLFVVEV	RQLLFVVEV
KLMALELFK	KLMALELFK
FMSMVSHEL	FMSMVSHEL
SILSPFLPL	SILSPFLPL
ALDQACFRI	ALDQACFRI
YLYPWSLGL	YLYPWSLGL
YLFPGPVYV	YLFPGPVYV
GLYPQLSAI	GLYPQLSAI
LQAAIFHAL	LQAAIFHAL
TIAGGVCYYL	TIAGVCYYL
LMIGTAAAV	LMIGTAAAV
WLGHPFTPV	WLGHPFTPV
LILGAQALPV	ILGAQALPV
FFGWEGVGV	FFGWEGVGV
KMVELVHFLLL	KMVELVHFL
LLNVQTLISL	LLNVTLISL
WMTTEDMLSV	MTTEDMLSV
TMKEKSWLV	TMKEKSWLV
TLLMNELGV	TLLMNELGV
MLVNGDDLVV	MLVNGDDLV
MMWDLKKKGL	MMWDKKKGL
VLALYSPPLI	VLALYSPPL
GIILLILSCI	IILLILSCI
KIGDKFQTV	KIGDKFQTV
LLVISGLFPV	LLVIGLFPV
ILWQVPFSV	ILWQVPFSV
VLLLDVTPL	VLLLDVTPL
YMLSWGKEA	YMLSWGKEA
FLEEMLRTRV	FLEELRTRV
VLAFITFLRV	VLAFTFLRV
GLLQFIVFLL	GLLQFIVFL
LLLWFNYLF	LLLWFNYLF
IISCTCPTV	IISCTCPTV
LNASYITPYV	NASYITPYV
ALDGVLSTFV	ALDGLSTFV
ALIRILQQL	ALIRILQQL
NQMIFVSSI	NQMIFVSSI
IMRVMANNV	IMRVMANNV
LLPLGYPFV	LLPLGYPFV
MLLILCVTQV	LLILCVTQV
FMHSAAPIT	FMHSAAPIT
ELLEPLYDV	ELLEPLYDV
QMDYSNGLFV	QMDYNGLFV
RAMRMVYYL	RAMRMVYYL
LLSGAGEHL	LLSGAGEHL
RMIAISAKV	RMIAISAKV
FMSVVNTNI	FMSVVNTNI
MSDIFASEV	MSDIFASEV
GIAWYVTSI	GIAWYVTSI
LLSALGLSV	LLSALGLSV
YLEPGPVTL	YLEPGPVTL
GIPPAPHGV	GIPPAPHGV
TLLCLIPTA	TLLCLIPTA
VLLLITHYA	VLLLITHYA
LMDENTYAM	LMDENTYAM
GLYEAIEEC	GLYEAIEEC
WLLCKLSCA	WLLCKLSCA
SLRNWIATL	SLRNWIATL
KQSSFLSSL	KQSSFLSSL
YMIYMSGLA	YMIYMSGLA
ILGTVSWNL	ILGTVSWNL
SMHYKLDEV	SMHYKLDEV
TIMAVLFVV	TIMAVLFVV
TMTDDIGMGV	MTDDIGMGV
AIILASFSA	AIILASFSA
LLTACTIFY	LLTACTIFY
FLVGVAIILV	FLVGAIILV
ELMESRMRI	ELMESRMRI
LLAALFHDI	LLAALFHDI
YLYPGPVTV	YLYPGPVTV
SQMTSTFIML	QMTSTFIML
NTSAGFPYV	NTSAGFPYV
SMMVILPDKI	SMMVLPDKI
SLLSVLLSM	SLLSVLLSM
NLGNLNVSI	NLGNLNVSI
MMCYFLTATP	MMCYFLTAT
FLWGPRALI	FLWGPRALI
LMMMLPATL	LMMMLPATL
SMFYGIFPS	SMFYGIFPS
SLFLPKLVV	SLFLPKLVV
QVMLLVLCAV	VMLLVLCAV
SLARGFPFV	SLARGFPFV
SLANTVATL	SLANTVATL
ILFNLSKFLL	ILFNSKFLL
KLPSDYFPSV	KLPSYFPSV
SLNFLGGTTV	SLNFGGTTV
SIYEVGIVL	SIYEVGIVL
GLDVKNVQL	GLDVKNVQL
RLFDFNKQAI	RLFDFNKQA
YLSPGPVTA	YLSPGPVTA
VLMMRTTWAL	LMMRTTWAL
LLMEGLKLLS	LLMEGLKLL
GLAHAAAAV	GLAHAAAAV
LVFGIEVVEV	LVFGEVVEV
FTMGVLCLAI	FTMGVLCLA
WMMAMRYPI	WMMAMRYPI
AMQDPNPEV	AMQDPNPEV
QLEELEDEL	QLEELEDEL
YQLEMYHPI	YQLEMYHPI
ALLKHRFEI	ALLKHRFEI
ALMEWLKTRPI	ALMEWLKTR
RQLLWRYQI	RQLLWRYQI
LLLLGLMILL	LLLGLMILL
MMIMIKFMGV	MIMIKFMGV
LLLTIGLSLV	LLLTGLSLV
ILSNKLLYA	ILSNKLLYA
FMKDGRSLVV	FMKDGRSLV
YLMTLMKGA	YLMTLMKGA
ITATFTAPL	ITATFTAPL
VLVGVVTLYL	VLVGVTLYL
TLVDLCFWS	TLVDLCFWS
QLMYDIINSV	LMYDIINSV
KLWTSISCA	KLWTSISCA
WQNLAWAGV	WQNLAWAGV
NVLAWLYAA	NVLAWLYAA
GLSRYVAL	GLSR-YVAL
YMGEDGCWYG	YMGEGCWYG
AMLDVDLHPA	AMLDDLHPA
RLLPLLALLAL	RLLPLLALL
AISYCRAFI	AISYCRAFI
RVATENIAV	RVATENIAV
LMHATYFLA	LMHATYFLA
VLAGGVLAAV	VLAGVLAAV
FMTATPPGSV	FMTAPPGSV
TLPELNLSL	TLPELNLSL
RLFGEAPREL	RLFGAPREL
GLDVLTAKV	GLDVLTAKV
FANTEFTLV	FANTEFTLV
TMLLMLLPTA	MLLMLLPTA
FIPQYLSAV	FIPQYLSAV
LLMRTTWAL	LLMRTTWAL
GLILFVLAL	GLILFVLAL
LLMWITQCFL	LLMWTQCFL
KCIDFYSRI	KCIDFYSRI
ALNSKDAAL	ALNSKDAAL
GLVDVCFWS	GLVDVCFWS
FLYVVCSLA	FLYVVCSLA
YPPPRYITV	YPPPRYITV
FLAASALGV	FLAASALGV
YMYQYIQEL	YMYQYIQEL
KLYFWIPWS	KLYFWIPWS
FVLPHWYMA	FVLPHWYMA
MVVKVNAAL	MVVKVNAAL
GIDGNVTFTV	GIDGVTFTV
IIDREVVANV	IIDRVVANV
SLDVINYLI	SLDVINYLI
WLYGYNFII	WLYGYNFII
SLFNAVVTL	SLFNAVVTL
YMLFTKFFYL	MLFTKFFYL
ELRRQVDQL	ELRRQVDQL
ALEAKIAQL	ALEAKIAQL
MMGMFNMLSTV	GMFNMLSTV
TIHCFFFAV	TIHCFFFAV
LQFGFGWFS	LQFGFGWFS
AVASGLLWV	AVASGLLWV
GMANTTFHV	GMANTTFHV
WTLAKPDFV	WTLAKPDFV
YLQLFFGIEV	YLQLFGIEV
NLNFDQAAL	NLNFDQAAL
YFLESNFFI	YFLESNFFI
LIHQGMHMV	LIHQGMHMV
FMPDFDLHL	FMPDFDLHL
FMGVLVNSL	FMGVLVNSL
YMPTVIEHL	YMPTVIEHL
MLSVVGFLV	MLSVVGFLV
LLMDCSGSI	LLMDCSGSI
LLSYYVVYV	LLSYYVVYV
SLLFKTEDGV	LLFKTEDGV
SVYSWAIML	SVYSWAIML
ALIHHNTYL	ALIHHNTYL
ALSMADIFI	ALSMADIFI
STYWVIPWEL	STYWIPWEL
KSLYNTVATL	SLYNTVATL
HLIKIPLLI	HLIKIPLLI
ILTLANWCL	ILTLANWCL
QMLSVVGFL	QMLSVVGFL
RMQFSSFTV	RMQFSSFTV
FQGRGVFEL	FQGRGVFEL
SVVALSPYV	SVVALSPYV
SVDVDIYDAV	SVDVIYDAV
MLLIAQAEA	MLLIAQAEA
GQWDGWVWL	GQWDGWVWL
WTFTPTTPL	WTFTPTTPL
RFLEDYFGV	RFLEDYFGV
GIYGAVIPL	GIYGAVIPL
KMDIDVEYL	KMDIDVEYL
SLAAIANQAV	SLAAANQAV
QLADETLLKV	QLADTLLKV
AQIGIFAPV	AQIGIFAPV
MLQDMAILT	MLQDMAILT
VILAGPIPV	VILAGPIPV
TLSRHIFMA	TLSRHIFMA
HLDGEVLSL	HLDGEVLSL
LMMATIGIAL	LMMAIGIAL
LLPDSDVFV	LLPDSDVFV
IIMRRFFYF	IIMRRFFYF
FTMGVLCLA	FTMGVLCLA
ILYQVPFSV	ILYQVPFSV
STKNILVTV	STKNILVTV
VLLPSLFLL	VLLPSLFLL
FLHNYILYA	FLHNYILYA
VLDEVMSTL	VLDEVMSTL
ILNPYMPSV	ILNPYMPSV
FLPPQIPVI	FLPPQIPVI
LLQEENRQKL	LLQENRQKL
AMPKTIYEL	AMPKTIYEL
LLSSNLSWL	LLSSNLSWL
RLPLYEALV	RLPLYEALV
NLPIYSEEI	NLPIYSEEI
VLCGIAWYV	VLCGIAWYV
RMGELTAEI	RMGELTAEI
LLFEVEQEI	LLFEVEQEI
FLSHKIHVI	FLSHKIHVI
FLYALALLL	FLYALALLL
FLYGAALLA	FLYGAALLA
YLRQRQAAL	YLRQRQAAL
GLLEAGNSL	GLLEAGNSL
ALLATSIFKL	ALLASIFKL
FMPKVNFEV	FMPKVNFEV
KLFTIAMWLL	KLFTAMWLL
RTSFFLWVI	RTSFFLWVI
LMMTTIGIVL	LMMTIGIVL
RSLFNTIATLY	SLFNTIATL
ALYGFVPVL	ALYGFVPVL
GHMMVIFRL	GHMMVIFRL
LLDFELACL	LLDFELACL
YLMKDKLNI	YLMKDKLNI
SLYNKVATL	SLYNKVATL
CLMMILPAAL	LMMILPAAL
DVLPFDIKYI	VLPFDIKYI
RLQQELDDLL	LQQELDDLL
GLLGVVSTV	GLLGVVSTV
GLSCLLAAL	GLSCLLAAL
VLLNGWRWRL	LLNGWRWRL
ILHVDNHIGI	ILHVNHIGI
VLFLQMMNV	VLFLQMMNV
RMYGVLPWI	RMYGVLPWI
YIWKSYVHI	YIWKSYVHI
TVYPKTHYV	TVYPKTHYV
LLLEVEQEI	LLLEVEQEI
SLADISLGA	SLADISLGA
GLFQEAYPL	GLFQEAYPL
FLLSLFSLWL	FLLSFSLWL
FSLGLLCISI	SLGLLCISI
KLARASFIEV	KLARSFIEV
YLAPGPVTV	YLAPGPVTV
QVNDVLHSV	QVNDVLHSV
LLFLKDVEP	LLFLKDVEP
FLMAPDLYV	FLMAPDLYV
LLGGVMAAV	LLGGVMAAV
FLYIIKLVFL	FLYIKLVFL
MQDVFTFYV	MQDVFTFYV
YTDEVYDYL	YTDEVYDYL
IMIGHLVGV	IMIGHLVGV
VLGAAVYAL	VLGAAVYAL
KVLNPYMPTV	VLNPYMPTV
FLLYILFLV	FLLYILFLV
GMLWMAEIPL	MLWMAEIPL
YIACRTSIV	YIACRTSIV
LLPGVAHSI	LLPGVAHSI
AIYHPQQFV	AIYHPQQFV
WLLPLWAALPL	WLLPLWAAL
MILMTHFFSI	ILMTHFFSI
LLSLLVIWI	LLSLLVIWI
SIMETIDPV	SIMETIDPV
GLCNYGGIL	GLCNYGGIL
FGAQMGWPV	FGAQMGWPV
YSLEYFQFV	YSLEYFQFV
KVFFVNWFR	KVFFVNWFR
QLASILGCVD	QLASILGCV
TLKDAMLQL	TLKDAMLQL
YLYPGPVTA	YLYPGPVTA
RSLYNTVAVL	SLYNTVAVL
SLFNWLWYE	SLFNWLWYE
FQWWRSHPL	FQWWRSHPL
FIHFFTWGT	FIHFFTWGT
FLNEDHWFS	FLNEDHWFS
LSMGLITIAV	SMGLITIAV
SISPIDWSV	SISPIDWSV
KMLDPRQGL	KMLDPRQGL
ILSPFMPLL	ILSPFMPLL
ALWGPDPAAA	ALWGPDPAA
MLMAASRAL	MLMAASRAL
MVWESGCTV	MVWESGCTV
IVPDIKLDAV	IVPDKLDAV
LVVTAIVYV	LVVTAIVYV
LLWKGEGAVV	LLWKEGAVV
VLSDFRTWL	VLSDFRTWL
SLLSMITMSA	SLLSITMSA
AMAKAAAAV	AMAKAAAAV
FTYASALWEI	FTYAALWEI
KSLFNTIATL	SLFNTIATL
FLLTSLRRA	FLLTSLRRA
NLIYRNLHL	NLIYRNLHL
RIWSWLLGA	RIWSWLLGA
YLLDDVLYT	YLLDDVLYT
HLMRDPALL	HLMRDPALL
KQITNELNYV	KQITELNYV
ELVKHGLRAL	LVKHGLRAL
ALAKAAAAA	ALAKAAAAA
RLFEESLGI	RLFEESLGI
ILLVAVSFV	ILLVAVSFV
YIAGLKIEEI	YIAGKIEEI
FLAVGGVLL	FLAVGGVLL
AMFWSVPTV	AMFWSVPTV
DLWNVMYTL	DLWNVMYTL
CLLCNLLLV	CLLCNLLLV
YINMAWNLV	YINMAWNLV
SLGQHIYET	SLGQHIYET
LLNESNIFL	LLNESNIFL
YQGKTVWFV	YQGKTVWFV
LITNTIAGV	LITNTIAGV
LLMGCDIVL	LLMGCDIVL
AMAGSIDLL	AMAGSIDLL
LTIVFVPEV	LTIVFVPEV
HLCGSHLVEA	HLCGHLVEA
IMNEGWASF	IMNEGWASF
LLMLCLHHA	LLMLCLHHA
SLSHYFTLVF	SLSHYFTLV
SLYLTVATL	SLYLTVATL
YSMAGNWAKV	SMAGNWAKV
GVDPNIRTGV	GVDPIRTGV
MLGEQLFPL	MLGEQLFPL
TVMVKINPTL	VMVKINPTL
IMAVGIVSI	IMAVGIVSI
NLYNIRNLHI	NLYNRNLHI
KMEDSVGCL	KMEDSVGCL
FLPVDFFPSI	FLPVFFPSI
ATAGWTFGA	ATAGWTFGA
TLTAALLLLV	LTAALLLLV
SLYNTISVL	SLYNTISVL
TLACFVLAA	TLACFVLAA
GMDPRMCSL	GMDPRMCSL
FMYTKHSML	FMYTKHSML
WLIEPCKLL	WLIEPCKLL
GLVDFVKHI	GLVDFVKHI
MLLMLLPTA	MLLMLLPTA
SMMSFSAAL	SMMSFSAAL
FLAFFSNGV	FLAFFSNGV
FLSRVFFCV	FLSRVFFCV
ATGDYVAFV	ATGDYVAFV
FMKVKFEAL	FMKVKFEAL
LLPENNVLSPL	LLPEVLSPL
AVFGVVAIV	AVFGVVAIV
GLLLLCVGV	GLLLLCVGV
LLIHQGMHM	LLIHQGMHM
VVTGVLVYL	VVTGVLVYL
YLACKQHAL	YLACKQHAL
AMKADIQHV	AMKADIQHV
ILYAAFLWL	ILYAAFLWL
KLINTLFHA	KLINTLFHA
ILEDQNCKL	ILEDQNCKL
YLTLGGHTV	YLTLGGHTV
MLSTVLGVSI	MLSTLGVSI
SILISLTNEI	ILISLTNEI
RMDLGVPLL	RMDLGVPLL
YTLNNGVAM	YTLNNGVAM
RLNKRSYLI	RLNKRSYLI
LLGLWGFATA	LLGLGFATA
ALAVVNALL	ALAVVNALL
FLPSDFFPSI	FLPSFFPSI
MLSTVLGV	MLST-VLGV
YLIRALTLNTM	YLIRLTLNT
LLGMWGIAAI	LLGMGIAAI
TLKYPIEHGI	TLKYIEHGI
LLAPITAYA	LLAPITAYA
FLPSDFFPSVR	FLPSFFPSV
KVDTTHVSKV	KVDTHVSKV
GALPICSFVV	ALPICSFVV
FLAALFYTS	FLAALFYTS
AMLQDMAIL	AMLQDMAIL
GMFGGCFAA	GMFGGCFAA
LMMSSPPPI	LMMSSPPPI
NLAPHLLLIV	NLAPHLLLI
IYDFYNAEY	IYDFYNAEY
FLLQLNETI	FLLQLNETI
DLMEFIDGI	DLMEFIDGI
KLVVVAVGV	KLVVVAVGV
KVADLVGFLL	KVADVGFLL
ALLQQTWTL	ALLQQTWTL
RLARCLTPA	RLARCLTPA
MLIKGVDLV	MLIKGVDLV
TLLQAAPTL	TLLQAAPTL
KLLGTWMFSV	KLLGWMFSV
FMDPGIFPR	FMDPGIFPR
EMADYIFFV	EMADYIFFV
VLQRNCAAYL	VLQRCAAYL
ILLEDSSGNLV	ILLESSGNL
GLADQLIHM	GLADQLIHM
ILDSFDPLV	ILDSFDPLV
FMKDGRSLV	FMKDGRSLV
RSLYNTIATL	SLYNTIATL
FLYCYFALV	FLYCYFALV
SMIFSVLDA	SMIFSVLDA
ILGAQALPV	ILGAQALPV
GLVLVWYTV	GLVLVWYTV
FTFGDTALYV	FTFGTALYV
GLPRYVVCL	GLPRYVVCL
RMAWGGSYIA	RMAWGGSYI
FLTPLSVTL	FLTPLSVTL
KTWKPTIFL	KTWKPTIFL
KVAELVWFL	KVAELVWFL
ELNGKNIEDV	ELNGNIEDV
VILGVLLLI	VILGVLLLI
ELMMTTIGVV	LMMTTIGVV
YLSEGDMAA	YLSEGDMAA
FANHNFTLV	FANHNFTLV
GLLCVMASSV	GLLCMASSV
TLQDIVLHL	TLQDIVLHL
FTGEYLLRL	FTGEYLLRL
YTVAYQATV	YTVAYQATV
VMAARPMVV	VMAARPMVV
FMVAWGKEA	FMVAWGKEA
LMQDCAIKA	LMQDCAIKA
SQLPPACPV	SQLPPACPV
WTMKILIGV	WTMKILIGV
TVSERILPL	TVSERILPL
FLPSDKFPSV	FLPSKFPSV
MMMGMFNML	MMMGMFNML
VLSDLCNFL	VLSDLCNFL
LLLDVTPLSL	LLLDTPLSL
LMDGHTGMV	LMDGHTGMV
SLTDRELLL	SLTDRELLL
SLFNTVVTL	SLFNTVVTL
MQLMPFGCLL	QLMPFGCLL
SLYNVVATL	SLYNVVATL
HMTEVVRRC	HMTEVVRRC
ALDGGNKHFL	ALDGNKHFL
RQMATTTNPLI	QMATTTNPL
YMYDFILRF	YMYDFILRF
VLTHGLASV	VLTHGLASV
KSLYNTIATL	SLYNTIATL
GIYCTVPFI	GIYCTVPFI
SIFLHLVKI	SIFLHLVKI
LLALLSCLTI	LLALSCLTI
QEPGIFCAI	QEPGIFCAI
FLVFLVFSNV	FLVFVFSNV
ALPDPILQSI	ALPDILQSI
ALPHAILRL	ALPHAILRL
ALIFILLTAV	ALIFLLTAV
YTFWRLDLV	YTFWRLDLV
FLCTADAAV	FLCTADAAV
TQLMPFGCLL	QLMPFGCLL
LLATSIFKL	LLATSIFKL
KLVSISNFI	KLVSISNFI
INISGYNFSL	NISGYNFSL
YLIPFIWFV	YLIPFIWFV
LLLDDSLVSI	LLLDSLVSI
ITLSLSKQDI	TLSLSKQDI
VMNPLGLNV	VMNPLGLNV
MLAKYDHLV	MLAKYDHLV
GLLIVKTVL	GLLIVKTVL
YLAEADLSYT	YLAEDLSYT
KQLESVMYL	KQLESVMYL
WVIDTLNGI	WVIDTLNGI
GSFGDIYLA	GSFGDIYLA
IMALKQAGL	IMALKQAGL
KLEEEQIIL	KLEEEQIIL
LLMALPHQA	LLMALPHQA
FTTSLFLHL	FTTSLFLHL
FIDILLFVI	FIDILLFVI
SMLSYGNVL	SMLSYGNVL
KMSPGYVLGV	KMSPYVLGV
ALGYQLAFV	ALGYQLAFV
ILTGLNYEV	ILTGLNYEV
QMISPVMSV	QMISPVMSV
CLGGLLTMV	CLGGLLTMV
FLSDSEAEA	FLSDSEAEA
DALATFTVNI	ALATFTVNI
ILNRETLLDFV	ILNRLLDFV
AMVGAVLTA	AMVGAVLTA
VTLLCVLPAV	TLLCVLPAV
YLLLRVLNI	YLLLRVLNI
FICNLLLLFV	FICNLLLFV
LLYDGSFAV	LLYDGSFAV
RLLDLSSWFT	RLLDSSWFT
FLKNRFEAL	FLKNRFEAL
FIPIIYSKA	FIPIIYSKA
YLCPVLVFV	YLCPVLVFV
TSMAMTCIAV	SMAMTCIAV
VLETAVGLL	VLETAVGLL
ILGIFNEFV	ILGIFNEFV
IQPGQTFSV	IQPGQTFSV
LLYLITNYL	LLYLITNYL
ALLAYRCVL	ALLAYRCVL
FTWYGIAAL	FTWYGIAAL
SLCADARMYGV	SLCARMYGV
VISVIFYFI	VISVIFYFI
KLHEEEIQEL	KLHEEIQEL
LLMRTSWAL	LLMRTSWAL
MMATIGIALL	MMATGIALL
LLILCVTQV	LLILCVTQV
LPTWLGAAI	LPTWLGAAI
LLTYLEYPI	LLTYLEYPI
VLLAFLNSM	VLLAFLNSM
ALMEVTHVL	ALMEVTHVL
HLREYQDLL	HLREYQDLL
EMIRYMALV	EMIRYMALV
FLGGHVAVA	FLGGHVAVA
YLNKIQNSL	YLNKIQNSL
FLQEETLTQM	FLQETLTQM
FMMVLPGAA	FMMVLPGAA
GMMRWCMPV	GMMRWCMPV
WLSDCGEAL	WLSDCGEAL
RVQFIPGQR	RVQFIPGQR
YLAPGPVTA	YLAPGPVTA
CLNEYHLFL	CLNEYHLFL
LLDVAPLSL	LLDVAPLSL
RMVSLVTSFL	RMVSVTSFL
GIMIGVLVGV	IMIGVLVGV
FIVEHINAM	FIVEHINAM
ILDAHSLYL	ILDAHSLYL
FAFRYVNRL	FAFRYVNRL
AMYVAIQAVL	AMYVAIQAV
AMHDKKIDIL	AMHDKIDIL
LLPEIAPNA	LLPEIAPNA
YVDIIGLSV	YVDIIGLSV
YQLAVTIMAI	QLAVTIMAI
TLSGMGYYL	TLSGMGYYL
YYFSYPLFV	YYFSYPLFV
MLASTLTDA	MLASTLTDA
MIAGVFFTFV	MIAGFFTFV
TMLMFIFTGI	MLMFIFTGI
YLSRRLNPL	YLSRRLNPL
KMAQCTLAV	KMAQCTLAV
FLDEFMEAV	FLDEFMEAV
LLGTWMFSV	LLGTWMFSV
SLDSLVHLL	SLDSLVHLL
FIRYGDASL	FIRYGDASL
ALCEALTLA	ALCEALTLA
SLYFGGICV	SLYFGGICV
RLPHICYPV	RLPHICYPV
QLWTALVSL	QLWTALVSL
ILAVDGVLSV	ILAVGVLSV
KLITQPLPA	KLITQPLPA
HAFLCLFLL	HAFLCLFLL
YVNAILYQI	YVNAILYQI
SLFEGIDIYT	SLFEIDIYT
SLPPNFSSL	SLPPNFSSL
GLGQYIYET	GLGQYIYET
KMSPGYVLGI	KMSPYVLGI
IVWEKKSLV	IVWEKKSLV
HMILAVVITL	MILAVVITL
YIVAYQATV	YIVAYQATV
VMSWAPPVGL	VMSWPPVGL
QIGDIIIAV	QIGDIIIAV
ILKKIIPTL	ILKKIIPTL
YLCSLAVVL	YLCSLAVVL
GLEAYIQGI	GLEAYIQGI
VLPATFAAV	VLPATFAAV
KQLELFWVI	KQLELFWVI
AMHARMAAV	AMHARMAAV
TTYVYTLPV	TTYVYTLPV
FLFLMSGKGI	FLFLSGKGI
YQIEGAWRA	YQIEGAWRA
KTVLELTEV	KTVLELTEV
LQQSTYQLV	LQQSTYQLV
RLDSLDLTL	RLDSLDLTL
VLEDVQAAGI	VLEDQAAGI
ALYNTAAAL	ALYNTAAAL
LLCCSGVATA	LLCCGVATA
ELDSNLYRI	ELDSNLYRI
WLYPGAQNL	WLYPGAQNL
IMLKANFSV	IMLKANFSV
LLTEVETYV	LLTEVETYV
YLVAKQATV	YLVAKQATV
RLMRTNFLI	RLMRTNFLI
YMWLGARFL	YMWLGARFL
GIMTIDLDPV	IMTIDLDPV
LLANTVRYL	LLANTVRYL
MLYAGAPTTV	MLYAAPTTV
GLLGCIITSL	GLLGIITSL
RAWGRRLMI	RAWGRRLMI
FLDEFMEGV	FLDEFMEGV
RLIVYPDLGV	LIVYPDLGV
LIWTLDANI	LIWTLDANI
FLGKIWPSYK	FLGKIWPSY
RLAELIGPA	RLAELIGPA
ALLGAMTAGI	ALLGMTAGI
KIDTTHVSKV	KIDTHVSKV
CLIFLLVLL	CLIFLLVLL
WIIKNSWTA	WIIKNSWTA
SLYSGFPSL	SLYSGFPSL
MLLAYLVRI	MLLAYLVRI
YMKPGSSPL	YMKPGSSPL
RTYSGPMNKV	RTYSPMNKV
FLYGALALA	FLYGALALA
LLGPVIGML	LLGPVIGML
LMMILPAALA	LMMILPAAL
SLYNTIAVLY	SLYNTIAVL
FILDNPGFV	FILDNPGFV
RMVLAFITFL	MVLAFITFL
AQSDFMSWV	AQSDFMSWV
RLLYPDYQI	RLLYPDYQI
LMMRTTWAL	LMMRTTWAL
MILAVVITL	MILAVVITL
LLLMGCDIV	LLLMGCDIV
LMSFTILCL	LMSFTILCL
SLIPDATHL	SLIPDATHL
RTFSIPLGV	RTFSIPLGV
VLNPYMPSV	VLNPYMPSV
LLLEHGQFDL	LLLEGQFDL
VLYGPDTPV	VLYGPDTPV
ILLMRTTWAL	LLMRTTWAL
FMRSISDDA	FMRSISDDA
YQLWTALISL	QLWTALISL
VLHDDLCEA	VLHDDLCEA
YQTYVSPGA	YQTYVSPGA
MALWMRLLPL	ALWMRLLPL
KSLYNTIAVLY	SLYNTIAVL
GLFGKTQVGV	GLFGTQVGV
FLARLHAAA	FLARLHAAA
YNLSLSAAV	YNLSLSAAV
DLMLLSYSL	DLMLLSYSL
TLGTVILLV	TLGTVILLV
VLSIVSLFPL	VLSISLFPL
ILMTHFFSI	ILMTHFFSI
SILGCDVSV	SILGCDVSV
SLVENALVV	SLVENALVV
IMYGGVFSL	IMYGGVFSL
FLLKQFHAA	FLLKQFHAA
YLHPKDKYL	YLHPKDKYL
TLYAVATTFI	TLYAATTFI
KLFCQLAKV	KLFCQLAKV
GMYYPTNDI	GMYYPTNDI
QVKDEKLNL	QVKDEKLNL
YLVTRNADV	YLVTRNADV
IVYLCPVLV	IVYLCPVLV
LQMENKAWLV	LQMEKAWLV
SMICLSLILA	SMICSLILA
YLLPAIVHI	YLLPAIVHI
CLLQSLQQI	CLLQSLQQI
KLLHHILPI	KLLHHILPI
LVSIPRTNIV	VSIPRTNIV
SLQQELAHM	SLQQELAHM
FLGKIWSS	FLGK-IWSS
RVASPTSGV	RVASPTSGV
FLKPEETFV	FLKPEETFV
FLYGALVLA	FLYGALVLA
SLYNAIATL	SLYNAIATL
SLADEAEVHL	SLADAEVHL
IILEFFLMV	IILEFFLMV
SLLMWITQC	SLLMWITQC
SLYPPCLFK	SLYPPCLFK
IMEYHLLFA	IMEYHLLFA
SEHFSLLFL	SEHFSLLFL
FLAMITYMT	FLAMITYMT
RLSPFPALV	RLSPFPALV
MILVPLITV	MILVPLITV
FMIAFISCFA	FMIAISCFA
KLREYEAAL	KLREYEAAL
ALIFILLTA	ALIFILLTA
TLDSQVMSL	TLDSQVMSL
AMHYIRHRA	AMHYIRHRA
AMLAGTAVV	AMLAGTAVV
YVLNSQIAV	YVLNSQIAV
GLGGLGLFFA	GLGGGLFFA
LLCPAGHAV	LLCPAGHAV
EMFGGTPAV	EMFGGTPAV
LTVKHMANV	LTVKHMANV
KLTEEIIKL	KLTEEIIKL
MTSELAALI	MTSELAALI
ILSQVPFSV	ILSQVPFSV
ILFTFLHLA	ILFTFLHLA
VLAGLLGNV	VLAGLLGNV
GILTVVWTA	GILTVVWTA
LLLNTTLTV	LLLNTTLTV
LQMEDKAWLV	LQMEKAWLV
FLHKRFTLV	FLHKRFTLV
ALYGVWPLLL	ALYGVWPLL
KLSMGLITI	KLSMGLITI
CLWPKTHTL	CLWPKTHTL
VICSFLVFL	VICSFLVFL
FIPSDYFPSV	FIPSYFPSV
LLSLFSLWL	LLSLFSLWL
YLLEKSRAI	YLLEKSRAI
MLYQHLLPL	MLYQHLLPL
ALVLLMLPV	ALVLLMLPV
ILDPKTGLV	ILDPKTGLV
MVIGMAMTTV	VIGMAMTTV
